sw,tier,Gender,Ethnicity,IEP,ELL,enrolled15,absences15,presences15,enrolled16,absences16,presences16
1,Elementary,Female,Black,No,0,1624,204,1420,2997,300,2697
1,Elementary,Female,Black,No,1,208,30,178,453,50,403
1,Elementary,Female,Black,Yes,0,293,42,251,555,72,483
1,Elementary,Female,Black,Yes,1,9,0,9,14,0,14
1,Elementary,Female,Hispanic,No,0,259,26,233,499,43,456
1,Elementary,Female,Hispanic,No,1,78,16,62,120,20,100
1,Elementary,Female,Hispanic,Yes,0,53,10,43,99,3,96
1,Elementary,Female,Hispanic,Yes,1,25,11,14,54,5,49
1,Elementary,Female,Other,No,0,386,41,345,833,72,761
1,Elementary,Female,Other,No,1,278,31,247,566,47,519
1,Elementary,Female,Other,Yes,0,62,9,53,142,11,131
1,Elementary,Female,Other,Yes,1,9,1,8,26,5,21
1,Elementary,Female,White,No,0,831,55,776,1534,117,1417
1,Elementary,Female,White,No,1,80,15,65,172,21,151
1,Elementary,Female,White,Yes,0,221,17,204,407,31,376
1,Elementary,Female,White,Yes,1,5,0,5,8,0,8
1,Elementary,Male,Black,No,0,1487,199,1288,2785,268,2517
1,Elementary,Male,Black,No,1,211,40,171,422,56,366
1,Elementary,Male,Black,Yes,0,609,93,516,1262,140,1122
1,Elementary,Male,Black,Yes,1,31,5,26,56,10,46
1,Elementary,Male,Hispanic,No,0,236,20,216,492,62,430
1,Elementary,Male,Hispanic,No,1,75,14,61,156,14,142
1,Elementary,Male,Hispanic,Yes,0,86,9,77,198,24,174
1,Elementary,Male,Hispanic,Yes,1,36,5,31,58,7,51
1,Elementary,Male,Other,No,0,349,41,308,756,69,687
1,Elementary,Male,Other,No,1,313,45,268,666,46,620
1,Elementary,Male,Other,Yes,0,125,18,107,278,33,245
1,Elementary,Male,Other,Yes,1,19,3,16,38,5,33
1,Elementary,Male,White,No,0,699,74,625,1271,117,1154
1,Elementary,Male,White,No,1,83,3,80,204,23,181
1,Elementary,Male,White,Yes,0,409,41,368,748,47,701
1,Elementary,Male,White,Yes,1,9,2,7,22,0,22
1,High,Female,Black,No,0,814,74,740,1599,113,1486
1,High,Female,Black,No,1,122,11,111,271,4,267
1,High,Female,Black,Yes,0,170,12,158,344,24,320
1,High,Female,Black,Yes,1,12,2,10,26,2,24
1,High,Female,Hispanic,No,0,130,10,120,251,14,237
1,High,Female,Hispanic,No,1,79,11,68,167,17,150
1,High,Female,Hispanic,Yes,0,25,3,22,36,4,32
1,High,Female,Hispanic,Yes,1,22,2,20,36,9,27
1,High,Female,Other,No,0,80,5,75,144,10,134
1,High,Female,Other,No,1,190,18,172,369,16,353
1,High,Female,Other,Yes,0,11,2,9,20,0,20
1,High,Female,Other,Yes,1,4,1,3,10,0,10
1,High,Female,White,No,0,382,12,370,732,28,704
1,High,Female,White,No,1,47,7,40,90,10,80
1,High,Female,White,Yes,0,100,7,93,164,9,155
1,High,Male,Black,No,0,709,66,643,1247,72,1175
1,High,Male,Black,No,1,128,4,124,253,4,249
1,High,Male,Black,Yes,0,291,38,253,544,56,488
1,High,Male,Black,Yes,1,15,1,14,28,0,28
1,High,Male,Hispanic,No,0,88,7,81,150,12,138
1,High,Male,Hispanic,No,1,99,12,87,179,30,149
1,High,Male,Hispanic,Yes,0,34,2,32,49,4,45
1,High,Male,Hispanic,Yes,1,38,6,32,76,13,63
1,High,Male,Other,No,0,55,2,53,130,6,124
1,High,Male,Other,No,1,201,15,186,373,29,344
1,High,Male,Other,Yes,0,31,2,29,56,3,53
1,High,Male,Other,Yes,1,5,0,5,15,0,15
1,High,Male,White,No,0,294,10,284,607,23,584
1,High,Male,White,No,1,52,3,49,90,3,87
1,High,Male,White,Yes,0,131,15,116,221,12,209
1,High,Male,White,Yes,1,2,0,2,6,2,4
1,Middle,Female,Black,No,0,468,9,459,1301,38,1263
1,Middle,Female,Black,No,1,69,2,67,211,2,209
1,Middle,Female,Black,Yes,0,85,4,81,215,11,204
1,Middle,Female,Black,Yes,1,5,2,3,22,0,22
1,Middle,Female,Hispanic,No,0,83,3,80,198,6,192
1,Middle,Female,Hispanic,No,1,42,1,41,97,4,93
1,Middle,Female,Hispanic,Yes,0,12,1,11,37,2,35
1,Middle,Female,Hispanic,Yes,1,10,1,9,32,1,31
1,Middle,Female,Other,No,0,70,2,68,143,0,143
1,Middle,Female,Other,No,1,100,2,98,240,2,238
1,Middle,Female,Other,Yes,0,15,1,14,26,0,26
1,Middle,Female,Other,Yes,1,2,0,2,2,0,2
1,Middle,Female,White,No,0,296,4,292,611,16,595
1,Middle,Female,White,No,1,27,1,26,66,0,66
1,Middle,Female,White,Yes,0,60,1,59,141,2,139
1,Middle,Female,White,Yes,1,2,1,1,4,0,4
1,Middle,Male,Black,No,0,418,12,406,1176,32,1144
1,Middle,Male,Black,No,1,67,3,64,210,2,208
1,Middle,Male,Black,Yes,0,214,3,211,503,13,490
1,Middle,Male,Black,Yes,1,14,0,14,24,0,24
1,Middle,Male,Hispanic,No,0,59,4,55,187,7,180
1,Middle,Male,Hispanic,No,1,39,3,36,68,0,68
1,Middle,Male,Hispanic,Yes,0,36,2,34,82,1,81
1,Middle,Male,Hispanic,Yes,1,16,0,16,56,1,55
1,Middle,Male,Other,No,0,67,2,65,162,5,157
1,Middle,Male,Other,No,1,111,5,106,240,1,239
1,Middle,Male,Other,Yes,0,18,0,18,39,3,36
1,Middle,Male,Other,Yes,1,10,0,10,28,1,27
1,Middle,Male,White,No,0,306,4,302,579,10,569
1,Middle,Male,White,No,1,29,1,28,92,4,88
1,Middle,Male,White,Yes,0,118,2,116,316,11,305
1,Middle,Male,White,Yes,1,3,0,3,2,0,2
1,Other,Female,Black,No,0,486,56,430,1087,103,984
1,Other,Female,Black,No,1,22,2,20,54,8,46
1,Other,Female,Black,Yes,0,75,13,62,143,16,127
1,Other,Female,Black,Yes,1,2,0,2,4,0,4
1,Other,Female,Hispanic,No,0,159,16,143,328,38,290
1,Other,Female,Hispanic,No,1,183,32,151,370,66,304
1,Other,Female,Hispanic,Yes,0,17,2,15,42,10,32
1,Other,Female,Hispanic,Yes,1,41,9,32,82,19,63
1,Other,Female,Other,No,0,57,8,49,158,14,144
1,Other,Female,Other,No,1,33,0,33,82,4,78
1,Other,Female,Other,Yes,0,10,0,10,22,0,22
1,Other,Female,Other,Yes,1,3,1,2,4,0,4
1,Other,Female,White,No,0,150,19,131,337,27,310
1,Other,Female,White,No,1,12,2,10,26,6,20
1,Other,Female,White,Yes,0,29,0,29,81,7,74
1,Other,Female,White,Yes,1,2,1,1,4,2,2
1,Other,Male,Black,No,0,475,45,430,1054,113,941
1,Other,Male,Black,No,1,19,3,16,70,4,66
1,Other,Male,Black,Yes,0,180,20,160,352,42,310
1,Other,Male,Black,Yes,1,4,1,3,12,0,12
1,Other,Male,Hispanic,No,0,145,19,126,279,34,245
1,Other,Male,Hispanic,No,1,189,41,148,360,56,304
1,Other,Male,Hispanic,Yes,0,54,11,43,116,20,96
1,Other,Male,Hispanic,Yes,1,104,29,75,212,37,175
1,Other,Male,Other,No,0,52,5,47,149,11,138
1,Other,Male,Other,No,1,31,0,31,70,2,68
1,Other,Male,Other,Yes,0,26,3,23,54,5,49
1,Other,Male,White,No,0,171,14,157,369,32,337
1,Other,Male,White,No,1,8,1,7,20,5,15
1,Other,Male,White,Yes,0,93,7,86,188,19,169
1,Other,Male,White,Yes,1,4,1,3,14,3,11
2,Elementary,Female,Black,No,0,8160,768,7392,7614,578,7036
2,Elementary,Female,Black,No,1,1042,88,954,1146,122,1024
2,Elementary,Female,Black,Yes,0,1473,134,1339,1401,143,1258
2,Elementary,Female,Black,Yes,1,45,0,45,35,3,32
2,Elementary,Female,Hispanic,No,0,1300,141,1159,1253,103,1150
2,Elementary,Female,Hispanic,No,1,386,44,342,305,29,276
2,Elementary,Female,Hispanic,Yes,0,267,50,217,251,20,231
2,Elementary,Female,Hispanic,Yes,1,125,30,95,135,12,123
2,Elementary,Female,Other,No,0,1945,187,1758,2108,174,1934
2,Elementary,Female,Other,No,1,1385,124,1261,1406,108,1298
2,Elementary,Female,Other,Yes,0,320,32,288,359,39,320
2,Elementary,Female,Other,Yes,1,45,6,39,65,4,61
2,Elementary,Female,White,No,0,4158,302,3856,3861,308,3553
2,Elementary,Female,White,No,1,404,39,365,434,40,394
2,Elementary,Female,White,Yes,0,1112,101,1011,1031,96,935
2,Elementary,Female,White,Yes,1,25,0,25,20,0,20
2,Elementary,Male,Black,No,0,7410,658,6752,7013,492,6521
2,Elementary,Male,Black,No,1,1071,115,956,1063,85,978
2,Elementary,Male,Black,Yes,0,3087,320,2767,3175,240,2935
2,Elementary,Male,Black,Yes,1,159,15,144,140,21,119
2,Elementary,Male,Hispanic,No,0,1209,90,1119,1251,116,1135
2,Elementary,Male,Hispanic,No,1,384,30,354,393,41,352
2,Elementary,Male,Hispanic,Yes,0,438,34,404,498,64,434
2,Elementary,Male,Hispanic,Yes,1,175,21,154,145,13,132
2,Elementary,Male,Other,No,0,1770,179,1591,1933,185,1748
2,Elementary,Male,Other,No,1,1572,161,1411,1686,112,1574
2,Elementary,Male,Other,Yes,0,622,76,546,698,88,610
2,Elementary,Male,Other,Yes,1,96,6,90,95,10,85
2,Elementary,Male,White,No,0,3490,362,3128,3236,252,2984
2,Elementary,Male,White,No,1,428,31,397,515,45,470
2,Elementary,Male,White,Yes,0,2065,228,1837,1849,116,1733
2,Elementary,Male,White,Yes,1,45,1,44,55,1,54
2,High,Female,Black,No,0,4068,286,3782,4007,221,3786
2,High,Female,Black,No,1,617,34,583,676,12,664
2,High,Female,Black,Yes,0,841,65,776,852,52,800
2,High,Female,Black,Yes,1,63,2,61,68,1,67
2,High,Female,Hispanic,No,0,659,65,594,619,35,584
2,High,Female,Hispanic,No,1,408,65,343,421,33,388
2,High,Female,Hispanic,Yes,0,121,31,90,95,15,80
2,High,Female,Hispanic,Yes,1,110,25,85,90,5,85
2,High,Female,Other,No,0,407,26,381,369,17,352
2,High,Female,Other,No,1,956,78,878,924,52,872
2,High,Female,Other,Yes,0,57,10,47,50,6,44
2,High,Female,Other,Yes,1,20,2,18,25,1,24
2,High,Female,White,No,0,1908,130,1778,1849,114,1735
2,High,Female,White,No,1,228,27,201,225,11,214
2,High,Female,White,Yes,0,504,54,450,408,34,374
2,High,Male,Black,No,0,3593,255,3338,3161,183,2978
2,High,Male,Black,No,1,645,30,615,631,11,620
2,High,Male,Black,Yes,0,1458,157,1301,1371,133,1238
2,High,Male,Black,Yes,1,70,11,59,73,1,72
2,High,Male,Hispanic,No,0,452,51,401,375,26,349
2,High,Male,Hispanic,No,1,489,76,413,455,49,406
2,High,Male,Hispanic,Yes,0,170,32,138,129,6,123
2,High,Male,Hispanic,Yes,1,193,41,152,195,25,170
2,High,Male,Other,No,0,282,17,265,326,15,311
2,High,Male,Other,No,1,1001,92,909,927,60,867
2,High,Male,Other,Yes,0,155,14,141,140,7,133
2,High,Male,Other,Yes,1,25,2,23,38,0,38
2,High,Male,White,No,0,1472,74,1398,1506,64,1442
2,High,Male,White,No,1,260,30,230,225,16,209
2,High,Male,White,Yes,0,643,73,570,555,41,514
2,High,Male,White,Yes,1,10,0,10,9,4,5
2,Middle,Female,Black,No,0,2517,72,2445,3231,89,3142
2,Middle,Female,Black,No,1,397,6,391,530,10,520
2,Middle,Female,Black,Yes,0,452,15,437,534,29,505
2,Middle,Female,Black,Yes,1,30,7,23,55,0,55
2,Middle,Female,Hispanic,No,0,413,15,398,499,14,485
2,Middle,Female,Hispanic,No,1,220,6,214,238,4,234
2,Middle,Female,Hispanic,Yes,0,62,4,58,95,7,88
2,Middle,Female,Hispanic,Yes,1,50,4,46,80,2,78
2,Middle,Female,Other,No,0,343,11,332,360,13,347
2,Middle,Female,Other,No,1,522,3,519,607,17,590
2,Middle,Female,Other,Yes,0,78,8,70,65,4,61
2,Middle,Female,Other,Yes,1,10,0,10,5,0,5
2,Middle,Female,White,No,0,1502,59,1443,1529,51,1478
2,Middle,Female,White,No,1,154,6,148,165,2,163
2,Middle,Female,White,Yes,0,305,16,289,349,7,342
2,Middle,Female,White,Yes,1,10,3,7,10,0,10
2,Middle,Male,Black,No,0,2211,40,2171,2939,80,2859
2,Middle,Male,Black,No,1,360,22,338,525,9,516
2,Middle,Male,Black,Yes,0,1092,37,1055,1261,47,1214
2,Middle,Male,Black,Yes,1,70,0,70,60,2,58
2,Middle,Male,Hispanic,No,0,313,32,281,471,20,451
2,Middle,Male,Hispanic,No,1,198,5,193,170,1,169
2,Middle,Male,Hispanic,Yes,0,193,23,170,205,8,197
2,Middle,Male,Hispanic,Yes,1,76,17,59,140,7,133
2,Middle,Male,Other,No,0,345,25,320,404,16,388
2,Middle,Male,Other,No,1,580,36,544,603,17,586
2,Middle,Male,Other,Yes,0,94,3,91,95,4,91
2,Middle,Male,Other,Yes,1,55,1,54,70,2,68
2,Middle,Male,White,No,0,1520,43,1477,1447,34,1413
2,Middle,Male,White,No,1,164,12,152,230,7,223
2,Middle,Male,White,Yes,0,595,38,557,792,27,765
2,Middle,Male,White,Yes,1,15,0,15,5,0,5
2,Other,Female,Black,No,0,2459,236,2223,2724,188,2536
2,Other,Female,Black,No,1,110,6,104,130,11,119
2,Other,Female,Black,Yes,0,366,47,319,358,25,333
2,Other,Female,Black,Yes,1,10,0,10,10,0,10
2,Other,Female,Hispanic,No,0,809,113,696,825,72,753
2,Other,Female,Hispanic,No,1,932,126,806,928,101,827
2,Other,Female,Hispanic,Yes,0,87,9,78,105,20,85
2,Other,Female,Hispanic,Yes,1,209,32,177,205,35,170
2,Other,Female,Other,No,0,289,39,250,389,28,361
2,Other,Female,Other,No,1,165,4,161,205,7,198
2,Other,Female,Other,Yes,0,50,6,44,55,3,52
2,Other,Female,Other,Yes,1,15,5,10,10,0,10
2,Other,Female,White,No,0,738,85,653,845,66,779
2,Other,Female,White,No,1,60,3,57,65,6,59
2,Other,Female,White,Yes,0,146,3,143,218,27,191
2,Other,Female,White,Yes,1,10,5,5,10,3,7
2,Other,Male,Black,No,0,2364,174,2190,2643,186,2457
2,Other,Male,Black,No,1,105,5,100,175,13,162
2,Other,Male,Black,Yes,0,913,91,822,883,90,793
2,Other,Male,Black,Yes,1,20,5,15,30,0,30
2,Other,Male,Hispanic,No,0,714,85,629,696,61,635
2,Other,Male,Hispanic,No,1,950,143,807,908,96,812
2,Other,Male,Hispanic,Yes,0,270,46,224,289,36,253
2,Other,Male,Hispanic,Yes,1,537,57,480,530,67,463
2,Other,Male,Other,No,0,258,29,229,379,26,353
2,Other,Male,Other,No,1,151,2,149,175,8,167
2,Other,Male,Other,Yes,0,141,15,126,140,14,126
2,Other,Male,White,No,0,867,86,781,923,69,854
2,Other,Male,White,No,1,36,6,30,50,10,40
2,Other,Male,White,Yes,0,475,54,421,465,51,414
2,Other,Male,White,Yes,1,20,3,17,35,5,30
3,Elementary,Female,Black,No,0,8172,666,7506,7697,564,7133
3,Elementary,Female,Black,No,1,1045,82,963,1154,94,1060
3,Elementary,Female,Black,Yes,0,1486,116,1370,1404,136,1268
3,Elementary,Female,Black,Yes,1,45,1,44,35,1,34
3,Elementary,Female,Hispanic,No,0,1305,139,1166,1285,116,1169
3,Elementary,Female,Hispanic,No,1,384,41,343,313,23,290
3,Elementary,Female,Hispanic,Yes,0,267,29,238,250,20,230
3,Elementary,Female,Hispanic,Yes,1,125,21,104,135,13,122
3,Elementary,Female,Other,No,0,1948,169,1779,2131,210,1921
3,Elementary,Female,Other,No,1,1375,116,1259,1392,89,1303
3,Elementary,Female,Other,Yes,0,322,51,271,357,38,319
3,Elementary,Female,Other,Yes,1,45,5,40,65,3,62
3,Elementary,Female,White,No,0,4174,318,3856,3872,313,3559
3,Elementary,Female,White,No,1,419,32,387,435,38,397
3,Elementary,Female,White,Yes,0,1123,117,1006,1016,104,912
3,Elementary,Female,White,Yes,1,25,1,24,20,0,20
3,Elementary,Male,Black,No,0,7429,578,6851,7071,497,6574
3,Elementary,Male,Black,No,1,1067,93,974,1076,77,999
3,Elementary,Male,Black,Yes,0,3136,291,2845,3182,213,2969
3,Elementary,Male,Black,Yes,1,160,14,146,140,7,133
3,Elementary,Male,Hispanic,No,0,1216,93,1123,1250,119,1131
3,Elementary,Male,Hispanic,No,1,383,23,360,390,41,349
3,Elementary,Male,Hispanic,Yes,0,450,40,410,492,57,435
3,Elementary,Male,Hispanic,Yes,1,175,19,156,145,14,131
3,Elementary,Male,Other,No,0,1774,181,1593,1941,169,1772
3,Elementary,Male,Other,No,1,1576,133,1443,1699,88,1611
3,Elementary,Male,Other,Yes,0,613,82,531,693,75,618
3,Elementary,Male,Other,Yes,1,100,8,92,95,9,86
3,Elementary,Male,White,No,0,3482,342,3140,3247,280,2967
3,Elementary,Male,White,No,1,448,32,416,514,62,452
3,Elementary,Male,White,Yes,0,2066,186,1880,1839,143,1696
3,Elementary,Male,White,Yes,1,45,3,42,55,1,54
3,High,Female,Black,No,0,4094,347,3747,4030,232,3798
3,High,Female,Black,No,1,614,34,580,672,9,663
3,High,Female,Black,Yes,0,858,94,764,855,52,803
3,High,Female,Black,Yes,1,65,2,63,70,1,69
3,High,Female,Hispanic,No,0,665,63,602,622,41,581
3,High,Female,Hispanic,No,1,418,71,347,431,30,401
3,High,Female,Hispanic,Yes,0,120,31,89,95,11,84
3,High,Female,Hispanic,Yes,1,110,20,90,90,8,82
3,High,Female,Other,No,0,408,44,364,379,23,356
3,High,Female,Other,No,1,971,81,890,935,46,889
3,High,Female,Other,Yes,0,60,6,54,50,7,43
3,High,Female,Other,Yes,1,20,2,18,25,1,24
3,High,Female,White,No,0,1901,154,1747,1860,123,1737
3,High,Female,White,No,1,225,24,201,228,8,220
3,High,Female,White,Yes,0,511,60,451,402,36,366
3,High,Male,Black,No,0,3626,279,3347,3204,183,3021
3,High,Male,Black,No,1,651,37,614,648,11,637
3,High,Male,Black,Yes,0,1473,152,1321,1385,138,1247
3,High,Male,Black,Yes,1,70,13,57,74,0,74
3,High,Male,Hispanic,No,0,461,45,416,375,31,344
3,High,Male,Hispanic,No,1,488,77,411,466,39,427
3,High,Male,Hispanic,Yes,0,168,38,130,133,9,124
3,High,Male,Hispanic,Yes,1,200,34,166,198,26,172
3,High,Male,Other,No,0,290,17,273,330,22,308
3,High,Male,Other,No,1,1008,92,916,955,55,900
3,High,Male,Other,Yes,0,152,13,139,137,11,126
3,High,Male,Other,Yes,1,30,1,29,40,0,40
3,High,Male,White,No,0,1485,121,1364,1504,106,1398
3,High,Male,White,No,1,265,28,237,236,19,217
3,High,Male,White,Yes,0,659,82,577,553,52,501
3,High,Male,White,Yes,1,10,0,10,5,0,5
3,Middle,Female,Black,No,0,2545,80,2465,3215,91,3124
3,Middle,Female,Black,No,1,398,3,395,525,14,511
3,Middle,Female,Black,Yes,0,455,16,439,536,32,504
3,Middle,Female,Black,Yes,1,30,8,22,55,0,55
3,Middle,Female,Hispanic,No,0,408,15,393,507,21,486
3,Middle,Female,Hispanic,No,1,224,12,212,245,8,237
3,Middle,Female,Hispanic,Yes,0,60,0,60,95,13,82
3,Middle,Female,Hispanic,Yes,1,50,3,47,80,5,75
3,Middle,Female,Other,No,0,347,16,331,360,17,343
3,Middle,Female,Other,No,1,527,8,519,610,15,595
3,Middle,Female,Other,Yes,0,75,7,68,65,5,60
3,Middle,Female,Other,Yes,1,10,0,10,5,0,5
3,Middle,Female,White,No,0,1505,91,1414,1519,83,1436
3,Middle,Female,White,No,1,154,6,148,165,3,162
3,Middle,Female,White,Yes,0,309,28,281,350,10,340
3,Middle,Female,White,Yes,1,10,4,6,10,0,10
3,Middle,Male,Black,No,0,2236,71,2165,2945,71,2874
3,Middle,Male,Black,No,1,366,17,349,525,14,511
3,Middle,Male,Black,Yes,0,1081,44,1037,1262,45,1217
3,Middle,Male,Black,Yes,1,70,0,70,56,0,56
3,Middle,Male,Hispanic,No,0,314,27,287,486,21,465
3,Middle,Male,Hispanic,No,1,205,7,198,174,2,172
3,Middle,Male,Hispanic,Yes,0,182,15,167,206,14,192
3,Middle,Male,Hispanic,Yes,1,74,14,60,140,14,126
3,Middle,Male,Other,No,0,343,32,311,405,29,376
3,Middle,Male,Other,No,1,575,19,556,605,9,596
3,Middle,Male,Other,Yes,0,95,2,93,95,5,90
3,Middle,Male,Other,Yes,1,55,0,55,70,4,66
3,Middle,Male,White,No,0,1511,77,1434,1443,56,1387
3,Middle,Male,White,No,1,161,12,149,225,7,218
3,Middle,Male,White,Yes,0,593,31,562,793,44,749
3,Middle,Male,White,Yes,1,15,0,15,5,0,5
3,Other,Female,Black,No,0,2457,256,2201,2730,203,2527
3,Other,Female,Black,No,1,139,9,130,130,14,116
3,Other,Female,Black,Yes,0,356,43,313,363,27,336
3,Other,Female,Black,Yes,1,10,1,9,10,1,9
3,Other,Female,Hispanic,No,0,814,120,694,833,81,752
3,Other,Female,Hispanic,No,1,939,93,846,926,87,839
3,Other,Female,Hispanic,Yes,0,86,8,78,105,14,91
3,Other,Female,Hispanic,Yes,1,210,29,181,201,31,170
3,Other,Female,Other,No,0,298,38,260,403,33,370
3,Other,Female,Other,No,1,183,2,181,205,3,202
3,Other,Female,Other,Yes,0,48,4,44,55,4,51
3,Other,Female,Other,Yes,1,10,0,10,10,0,10
3,Other,Female,White,No,0,734,77,657,869,94,775
3,Other,Female,White,No,1,55,5,50,65,5,60
3,Other,Female,White,Yes,0,150,4,146,218,32,186
3,Other,Female,White,Yes,1,10,1,9,10,2,8
3,Other,Male,Black,No,0,2316,193,2123,2677,230,2447
3,Other,Male,Black,No,1,128,7,121,175,12,163
3,Other,Male,Black,Yes,0,889,88,801,896,99,797
3,Other,Male,Black,Yes,1,20,1,19,30,1,29
3,Other,Male,Hispanic,No,0,703,94,609,692,54,638
3,Other,Male,Hispanic,No,1,945,123,822,919,94,825
3,Other,Male,Hispanic,Yes,0,267,39,228,287,35,252
3,Other,Male,Hispanic,Yes,1,529,46,483,528,65,463
3,Other,Male,Other,No,0,251,27,224,374,28,346
3,Other,Male,Other,No,1,180,6,174,175,8,167
3,Other,Male,Other,Yes,0,131,9,122,141,9,132
3,Other,Male,White,No,0,855,99,756,927,76,851
3,Other,Male,White,No,1,35,4,31,50,12,38
3,Other,Male,White,Yes,0,463,35,428,493,68,425
3,Other,Male,White,Yes,1,20,2,18,35,6,29
4,Elementary,Female,Black,No,0,8127,532,7595,7753,589,7164
4,Elementary,Female,Black,No,1,1048,62,986,1172,224,948
4,Elementary,Female,Black,Yes,0,1506,125,1381,1400,110,1290
4,Elementary,Female,Black,Yes,1,50,3,47,35,6,29
4,Elementary,Female,Hispanic,No,0,1311,128,1183,1304,129,1175
4,Elementary,Female,Hispanic,No,1,380,37,343,312,24,288
4,Elementary,Female,Hispanic,Yes,0,265,33,232,253,26,227
4,Elementary,Female,Hispanic,Yes,1,130,10,120,135,15,120
4,Elementary,Female,Other,No,0,1939,169,1770,2130,192,1938
4,Elementary,Female,Other,No,1,1381,98,1283,1402,110,1292
4,Elementary,Female,Other,Yes,0,323,29,294,358,35,323
4,Elementary,Female,Other,Yes,1,46,4,42,65,6,59
4,Elementary,Female,White,No,0,4157,332,3825,3885,314,3571
4,Elementary,Female,White,No,1,421,36,385,440,104,336
4,Elementary,Female,White,Yes,0,1131,103,1028,1012,91,921
4,Elementary,Female,White,Yes,1,25,1,24,20,4,16
4,Elementary,Male,Black,No,0,7433,493,6940,7129,536,6593
4,Elementary,Male,Black,No,1,1059,71,988,1096,205,891
4,Elementary,Male,Black,Yes,0,3146,285,2861,3171,183,2988
4,Elementary,Male,Black,Yes,1,159,11,148,140,22,118
4,Elementary,Male,Hispanic,No,0,1226,75,1151,1252,112,1140
4,Elementary,Male,Hispanic,No,1,392,26,366,390,40,350
4,Elementary,Male,Hispanic,Yes,0,452,47,405,494,65,429
4,Elementary,Male,Hispanic,Yes,1,175,24,151,148,16,132
4,Elementary,Male,Other,No,0,1775,164,1611,1958,162,1796
4,Elementary,Male,Other,No,1,1585,102,1483,1704,137,1567
4,Elementary,Male,Other,Yes,0,610,64,546,691,67,624
4,Elementary,Male,Other,Yes,1,103,7,96,95,18,77
4,Elementary,Male,White,No,0,3468,249,3219,3255,303,2952
4,Elementary,Male,White,No,1,453,34,419,515,147,368
4,Elementary,Male,White,Yes,0,2060,193,1867,1837,121,1716
4,Elementary,Male,White,Yes,1,45,4,41,55,9,46
4,High,Female,Black,No,0,4090,314,3776,4046,269,3777
4,High,Female,Black,No,1,617,37,580,673,71,602
4,High,Female,Black,Yes,0,864,68,796,859,74,785
4,High,Female,Black,Yes,1,65,3,62,70,10,60
4,High,Female,Hispanic,No,0,676,58,618,635,56,579
4,High,Female,Hispanic,No,1,414,68,346,439,42,397
4,High,Female,Hispanic,Yes,0,110,25,85,95,11,84
4,High,Female,Hispanic,Yes,1,115,30,85,90,8,82
4,High,Female,Other,No,0,405,33,372,383,25,358
4,High,Female,Other,No,1,979,82,897,943,72,871
4,High,Female,Other,Yes,0,62,6,56,53,11,42
4,High,Female,Other,Yes,1,17,1,16,25,2,23
4,High,Female,White,No,0,1920,175,1745,1865,168,1697
4,High,Female,White,No,1,221,30,191,230,37,193
4,High,Female,White,Yes,0,518,74,444,408,46,362
4,High,Male,Black,No,0,3646,273,3373,3218,209,3009
4,High,Male,Black,No,1,652,39,613,671,51,620
4,High,Male,Black,Yes,0,1493,163,1330,1407,169,1238
4,High,Male,Black,Yes,1,70,16,54,75,6,69
4,High,Male,Hispanic,No,0,470,52,418,373,30,343
4,High,Male,Hispanic,No,1,488,68,420,465,49,416
4,High,Male,Hispanic,Yes,0,157,23,134,140,16,124
4,High,Male,Hispanic,Yes,1,198,32,166,208,28,180
4,High,Male,Other,No,0,294,20,274,326,20,306
4,High,Male,Other,No,1,1012,91,921,964,59,905
4,High,Male,Other,Yes,0,151,16,135,135,9,126
4,High,Male,Other,Yes,1,30,0,30,40,1,39
4,High,Male,White,No,0,1505,97,1408,1527,119,1408
4,High,Male,White,No,1,265,33,232,240,39,201
4,High,Male,White,Yes,0,650,79,571,553,57,496
4,High,Male,White,Yes,1,10,0,10,5,0,5
4,Middle,Female,Black,No,0,2543,88,2455,3202,102,3100
4,Middle,Female,Black,No,1,385,5,380,525,44,481
4,Middle,Female,Black,Yes,0,447,20,427,534,29,505
4,Middle,Female,Black,Yes,1,32,5,27,55,4,51
4,Middle,Female,Hispanic,No,0,405,20,385,502,17,485
4,Middle,Female,Hispanic,No,1,220,9,211,245,1,244
4,Middle,Female,Hispanic,Yes,0,60,3,57,95,7,88
4,Middle,Female,Hispanic,Yes,1,50,3,47,80,6,74
4,Middle,Female,Other,No,0,345,14,331,360,19,341
4,Middle,Female,Other,No,1,530,5,525,610,16,594
4,Middle,Female,Other,Yes,0,75,6,69,65,8,57
4,Middle,Female,Other,Yes,1,10,0,10,5,0,5
4,Middle,Female,White,No,0,1481,57,1424,1523,54,1469
4,Middle,Female,White,No,1,150,1,149,165,28,137
4,Middle,Female,White,Yes,0,308,16,292,350,7,343
4,Middle,Female,White,Yes,1,10,5,5,10,1,9
4,Middle,Male,Black,No,0,2260,65,2195,2938,80,2858
4,Middle,Male,Black,No,1,353,19,334,530,42,488
4,Middle,Male,Black,Yes,0,1084,28,1056,1275,65,1210
4,Middle,Male,Black,Yes,1,70,2,68,55,3,52
4,Middle,Male,Hispanic,No,0,305,15,290,484,29,455
4,Middle,Male,Hispanic,No,1,205,6,199,181,8,173
4,Middle,Male,Hispanic,Yes,0,188,9,179,206,5,201
4,Middle,Male,Hispanic,Yes,1,71,9,62,140,7,133
4,Middle,Male,Other,No,0,342,30,312,404,18,386
4,Middle,Male,Other,No,1,571,22,549,604,25,579
4,Middle,Male,Other,Yes,0,97,3,94,95,6,89
4,Middle,Male,Other,Yes,1,55,2,53,70,6,64
4,Middle,Male,White,No,0,1505,57,1448,1443,82,1361
4,Middle,Male,White,No,1,155,1,154,227,33,194
4,Middle,Male,White,Yes,0,594,24,570,798,52,746
4,Middle,Male,White,Yes,1,15,0,15,5,0,5
4,Other,Female,Black,No,0,2494,297,2197,2744,202,2542
4,Other,Female,Black,No,1,159,7,152,130,19,111
4,Other,Female,Black,Yes,0,353,60,293,362,31,331
4,Other,Female,Black,Yes,1,10,0,10,10,0,10
4,Other,Female,Hispanic,No,0,808,87,721,847,101,746
4,Other,Female,Hispanic,No,1,939,88,851,933,92,841
4,Other,Female,Hispanic,Yes,0,90,14,76,105,19,86
4,Other,Female,Hispanic,Yes,1,209,35,174,200,35,165
4,Other,Female,Other,No,0,303,36,267,407,38,369
4,Other,Female,Other,No,1,212,3,209,205,6,199
4,Other,Female,Other,Yes,0,45,2,43,55,6,49
4,Other,Female,Other,Yes,1,10,1,9,10,0,10
4,Other,Female,White,No,0,745,114,631,868,102,766
4,Other,Female,White,No,1,55,3,52,62,7,55
4,Other,Female,White,Yes,0,152,5,147,226,34,192
4,Other,Female,White,Yes,1,10,3,7,10,2,8
4,Other,Male,Black,No,0,2336,223,2113,2714,232,2482
4,Other,Male,Black,No,1,137,9,128,175,12,163
4,Other,Male,Black,Yes,0,857,65,792,918,119,799
4,Other,Male,Black,Yes,1,20,2,18,35,9,26
4,Other,Male,Hispanic,No,0,690,61,629,705,57,648
4,Other,Male,Hispanic,No,1,937,124,813,916,100,816
4,Other,Male,Hispanic,Yes,0,266,28,238,289,42,247
4,Other,Male,Hispanic,Yes,1,528,43,485,520,52,468
4,Other,Male,Other,No,0,246,28,218,379,36,343
4,Other,Male,Other,No,1,207,12,195,175,8,167
4,Other,Male,Other,Yes,0,125,8,117,146,17,129
4,Other,Male,White,No,0,854,141,713,927,65,862
4,Other,Male,White,No,1,34,6,28,50,11,39
4,Other,Male,White,Yes,0,461,52,409,493,61,432
4,Other,Male,White,Yes,1,20,1,19,35,10,25
5,Elementary,Female,Black,No,0,8134,474,7660,7776,535,7241
5,Elementary,Female,Black,No,1,1053,42,1011,1195,79,1116
5,Elementary,Female,Black,Yes,0,1517,117,1400,1400,109,1291
5,Elementary,Female,Black,Yes,1,50,6,44,35,1,34
5,Elementary,Female,Hispanic,No,0,1298,87,1211,1304,97,1207
5,Elementary,Female,Hispanic,No,1,380,25,355,316,26,290
5,Elementary,Female,Hispanic,Yes,0,265,30,235,259,17,242
5,Elementary,Female,Hispanic,Yes,1,130,8,122,135,10,125
5,Elementary,Female,Other,No,0,1938,130,1808,2121,180,1941
5,Elementary,Female,Other,No,1,1382,81,1301,1404,80,1324
5,Elementary,Female,Other,Yes,0,325,29,296,361,42,319
5,Elementary,Female,Other,Yes,1,47,2,45,65,2,63
5,Elementary,Female,White,No,0,4123,269,3854,3871,256,3615
5,Elementary,Female,White,No,1,423,37,386,445,32,413
5,Elementary,Female,White,Yes,0,1118,84,1034,1015,96,919
5,Elementary,Female,White,Yes,1,25,2,23,20,1,19
5,Elementary,Male,Black,No,0,7459,446,7013,7139,428,6711
5,Elementary,Male,Black,No,1,1055,45,1010,1123,73,1050
5,Elementary,Male,Black,Yes,0,3165,280,2885,3185,232,2953
5,Elementary,Male,Black,Yes,1,155,2,153,140,8,132
5,Elementary,Male,Hispanic,No,0,1229,71,1158,1254,114,1140
5,Elementary,Male,Hispanic,No,1,400,23,377,393,44,349
5,Elementary,Male,Hispanic,Yes,0,452,46,406,497,71,426
5,Elementary,Male,Hispanic,Yes,1,175,14,161,150,24,126
5,Elementary,Male,Other,No,0,1759,123,1636,1969,162,1807
5,Elementary,Male,Other,No,1,1592,77,1515,1711,76,1635
5,Elementary,Male,Other,Yes,0,596,41,555,700,80,620
5,Elementary,Male,Other,Yes,1,105,4,101,95,10,85
5,Elementary,Male,White,No,0,3434,211,3223,3240,247,2993
5,Elementary,Male,White,No,1,455,23,432,523,47,476
5,Elementary,Male,White,Yes,0,2051,163,1888,1843,123,1720
5,Elementary,Male,White,Yes,1,45,2,43,55,5,50
5,High,Female,Black,No,0,4082,266,3816,4046,238,3808
5,High,Female,Black,No,1,616,33,583,677,16,661
5,High,Female,Black,Yes,0,872,72,800,859,63,796
5,High,Female,Black,Yes,1,65,0,65,70,2,68
5,High,Female,Hispanic,No,0,687,50,637,650,59,591
5,High,Female,Hispanic,No,1,409,68,341,443,52,391
5,High,Female,Hispanic,Yes,0,105,25,80,95,9,86
5,High,Female,Hispanic,Yes,1,109,24,85,90,10,80
5,High,Female,Other,No,0,410,45,365,394,21,373
5,High,Female,Other,No,1,985,88,897,954,53,901
5,High,Female,Other,Yes,0,65,4,61,55,3,52
5,High,Female,Other,Yes,1,20,2,18,25,1,24
5,High,Female,White,No,0,1927,160,1767,1864,160,1704
5,High,Female,White,No,1,225,23,202,226,13,213
5,High,Female,White,Yes,0,520,58,462,410,46,364
5,High,Male,Black,No,0,3671,245,3426,3221,195,3026
5,High,Male,Black,No,1,641,34,607,683,15,668
5,High,Male,Black,Yes,0,1479,130,1349,1393,166,1227
5,High,Male,Black,Yes,1,74,13,61,75,0,75
5,High,Male,Hispanic,No,0,480,44,436,377,28,349
5,High,Male,Hispanic,No,1,492,69,423,466,46,420
5,High,Male,Hispanic,Yes,0,146,20,126,140,20,120
5,High,Male,Hispanic,Yes,1,195,31,164,214,35,179
5,High,Male,Other,No,0,291,19,272,323,29,294
5,High,Male,Other,No,1,1017,95,922,976,55,921
5,High,Male,Other,Yes,0,159,15,144,139,15,124
5,High,Male,Other,Yes,1,30,0,30,40,0,40
5,High,Male,White,No,0,1510,99,1411,1530,112,1418
5,High,Male,White,No,1,265,28,237,240,21,219
5,High,Male,White,Yes,0,647,69,578,550,56,494
5,High,Male,White,Yes,1,10,0,10,5,0,5
5,Middle,Female,Black,No,0,2535,60,2475,3204,78,3126
5,Middle,Female,Black,No,1,385,3,382,526,13,513
5,Middle,Female,Black,Yes,0,443,13,430,535,26,509
5,Middle,Female,Black,Yes,1,35,0,35,55,0,55
5,Middle,Female,Hispanic,No,0,405,22,383,500,18,482
5,Middle,Female,Hispanic,No,1,216,9,207,245,5,240
5,Middle,Female,Hispanic,Yes,0,56,1,55,96,7,89
5,Middle,Female,Hispanic,Yes,1,50,5,45,80,2,78
5,Middle,Female,Other,No,0,339,11,328,355,6,349
5,Middle,Female,Other,No,1,528,7,521,610,6,604
5,Middle,Female,Other,Yes,0,70,3,67,65,9,56
5,Middle,Female,Other,Yes,1,10,1,9,5,0,5
5,Middle,Female,White,No,0,1477,43,1434,1523,44,1479
5,Middle,Female,White,No,1,148,4,144,169,7,162
5,Middle,Female,White,Yes,0,305,25,280,346,9,337
5,Middle,Female,White,Yes,1,8,1,7,10,1,9
5,Middle,Male,Black,No,0,2252,32,2220,2938,62,2876
5,Middle,Male,Black,No,1,346,5,341,538,12,526
5,Middle,Male,Black,Yes,0,1085,22,1063,1278,53,1225
5,Middle,Male,Black,Yes,1,70,2,68,55,0,55
5,Middle,Male,Hispanic,No,0,301,8,293,483,23,460
5,Middle,Male,Hispanic,No,1,203,7,196,180,2,178
5,Middle,Male,Hispanic,Yes,0,190,8,182,200,6,194
5,Middle,Male,Hispanic,Yes,1,66,4,62,140,13,127
5,Middle,Male,Other,No,0,335,19,316,402,17,385
5,Middle,Male,Other,No,1,565,19,546,600,12,588
5,Middle,Male,Other,Yes,0,100,5,95,95,5,90
5,Middle,Male,Other,Yes,1,55,1,54,70,4,66
5,Middle,Male,White,No,0,1497,68,1429,1457,59,1398
5,Middle,Male,White,No,1,157,6,151,230,1,229
5,Middle,Male,White,Yes,0,602,24,578,800,47,753
5,Middle,Male,White,Yes,1,15,1,14,5,0,5
5,Other,Female,Black,No,0,2471,231,2240,2792,197,2595
5,Other,Female,Black,No,1,173,3,170,133,14,119
5,Other,Female,Black,Yes,0,348,42,306,359,29,330
5,Other,Female,Black,Yes,1,10,1,9,10,4,6
5,Other,Female,Hispanic,No,0,793,76,717,857,79,778
5,Other,Female,Hispanic,No,1,920,89,831,923,87,836
5,Other,Female,Hispanic,Yes,0,85,8,77,101,13,88
5,Other,Female,Hispanic,Yes,1,205,37,168,200,37,163
5,Other,Female,Other,No,0,306,44,262,423,31,392
5,Other,Female,Other,No,1,216,1,215,205,4,201
5,Other,Female,Other,Yes,0,45,1,44,53,7,46
5,Other,Female,Other,Yes,1,10,0,10,10,0,10
5,Other,Female,White,No,0,732,93,639,866,79,787
5,Other,Female,White,No,1,55,3,52,60,1,59
5,Other,Female,White,Yes,0,153,13,140,230,40,190
5,Other,Female,White,Yes,1,10,1,9,10,2,8
5,Other,Male,Black,No,0,2326,199,2127,2763,183,2580
5,Other,Male,Black,No,1,141,4,137,174,11,163
5,Other,Male,Black,Yes,0,868,86,782,942,101,841
5,Other,Male,Black,Yes,1,20,3,17,37,4,33
5,Other,Male,Hispanic,No,0,673,59,614,710,68,642
5,Other,Male,Hispanic,No,1,924,100,824,914,86,828
5,Other,Male,Hispanic,Yes,0,265,33,232,291,43,248
5,Other,Male,Hispanic,Yes,1,534,47,487,513,70,443
5,Other,Male,Other,No,0,242,21,221,398,36,362
5,Other,Male,Other,No,1,215,7,208,175,7,168
5,Other,Male,Other,Yes,0,127,5,122,150,15,135
5,Other,Male,White,No,0,848,101,747,946,68,878
5,Other,Male,White,No,1,30,0,30,50,10,40
5,Other,Male,White,Yes,0,472,48,424,486,61,425
5,Other,Male,White,Yes,1,20,0,20,35,7,28
6,Elementary,Female,Black,No,0,8117,485,7632,6222,470,5752
6,Elementary,Female,Black,No,1,1053,56,997,959,37,922
6,Elementary,Female,Black,Yes,0,1520,141,1379,1117,87,1030
6,Elementary,Female,Black,Yes,1,50,4,46,28,1,27
6,Elementary,Female,Hispanic,No,0,1293,81,1212,1047,87,960
6,Elementary,Female,Hispanic,No,1,379,25,354,255,22,233
6,Elementary,Female,Hispanic,Yes,0,264,35,229,214,25,189
6,Elementary,Female,Hispanic,Yes,1,130,21,109,108,10,98
6,Elementary,Female,Other,No,0,1936,183,1753,1699,131,1568
6,Elementary,Female,Other,No,1,1380,128,1252,1131,53,1078
6,Elementary,Female,Other,Yes,0,325,28,297,288,27,261
6,Elementary,Female,Other,Yes,1,45,4,41,52,5,47
6,Elementary,Female,White,No,0,4105,234,3871,3100,238,2862
6,Elementary,Female,White,No,1,420,34,386,361,26,335
6,Elementary,Female,White,Yes,0,1115,83,1032,812,55,757
6,Elementary,Female,White,Yes,1,25,0,25,16,0,16
6,Elementary,Male,Black,No,0,7440,420,7020,5720,350,5370
6,Elementary,Male,Black,No,1,1059,56,1003,925,56,869
6,Elementary,Male,Black,Yes,0,3158,268,2890,2562,199,2363
6,Elementary,Male,Black,Yes,1,155,10,145,112,5,107
6,Elementary,Male,Hispanic,No,0,1226,95,1131,1001,96,905
6,Elementary,Male,Hispanic,No,1,400,25,375,312,31,281
6,Elementary,Male,Hispanic,Yes,0,449,44,405,405,57,348
6,Elementary,Male,Hispanic,Yes,1,175,26,149,123,23,100
6,Elementary,Male,Other,No,0,1756,146,1610,1571,119,1452
6,Elementary,Male,Other,No,1,1584,148,1436,1373,59,1314
6,Elementary,Male,Other,Yes,0,597,44,553,566,52,514
6,Elementary,Male,Other,Yes,1,105,9,96,76,9,67
6,Elementary,Male,White,No,0,3450,233,3217,2579,201,2378
6,Elementary,Male,White,No,1,455,51,404,424,27,397
6,Elementary,Male,White,Yes,0,2037,184,1853,1480,110,1370
6,Elementary,Male,White,Yes,1,45,7,38,44,1,43
6,High,Female,Black,No,0,4073,335,3738,3233,198,3035
6,High,Female,Black,No,1,615,36,579,567,12,555
6,High,Female,Black,Yes,0,874,82,792,684,35,649
6,High,Female,Black,Yes,1,65,1,64,56,1,55
6,High,Female,Hispanic,No,0,693,79,614,529,35,494
6,High,Female,Hispanic,No,1,401,63,338,352,30,322
6,High,Female,Hispanic,Yes,0,105,34,71,76,9,67
6,High,Female,Hispanic,Yes,1,110,26,84,72,3,69
6,High,Female,Other,No,0,410,46,364,315,11,304
6,High,Female,Other,No,1,981,137,844,768,24,744
6,High,Female,Other,Yes,0,65,10,55,44,5,39
6,High,Female,Other,Yes,1,20,3,17,20,0,20
6,High,Female,White,No,0,1931,198,1733,1490,95,1395
6,High,Female,White,No,1,225,38,187,180,10,170
6,High,Female,White,Yes,0,520,47,473,331,43,288
6,High,Male,Black,No,0,3663,279,3384,2580,161,2419
6,High,Male,Black,No,1,635,41,594,557,12,545
6,High,Male,Black,Yes,0,1484,116,1368,1121,113,1008
6,High,Male,Black,Yes,1,75,14,61,62,0,62
6,High,Male,Hispanic,No,0,479,48,431,300,14,286
6,High,Male,Hispanic,No,1,490,84,406,374,34,340
6,High,Male,Hispanic,Yes,0,150,13,137,112,4,108
6,High,Male,Hispanic,Yes,1,195,32,163,172,18,154
6,High,Male,Other,No,0,288,19,269,260,12,248
6,High,Male,Other,No,1,1019,172,847,783,37,746
6,High,Male,Other,Yes,0,160,15,145,114,12,102
6,High,Male,Other,Yes,1,30,1,29,32,0,32
6,High,Male,White,No,0,1504,107,1397,1221,87,1134
6,High,Male,White,No,1,261,31,230,204,15,189
6,High,Male,White,Yes,0,645,78,567,440,42,398
6,High,Male,White,Yes,1,10,1,9,4,0,4
6,Middle,Female,Black,No,0,2521,44,2477,2563,51,2512
6,Middle,Female,Black,No,1,377,8,369,430,13,417
6,Middle,Female,Black,Yes,0,444,19,425,428,21,407
6,Middle,Female,Black,Yes,1,35,1,34,44,3,41
6,Middle,Female,Hispanic,No,0,402,17,385,400,19,381
6,Middle,Female,Hispanic,No,1,211,6,205,198,5,193
6,Middle,Female,Hispanic,Yes,0,55,1,54,80,7,73
6,Middle,Female,Hispanic,Yes,1,50,0,50,64,6,58
6,Middle,Female,Other,No,0,340,13,327,284,5,279
6,Middle,Female,Other,No,1,525,28,497,492,11,481
6,Middle,Female,Other,Yes,0,70,2,68,52,8,44
6,Middle,Female,Other,Yes,1,10,1,9,4,0,4
6,Middle,Female,White,No,0,1475,38,1437,1225,35,1190
6,Middle,Female,White,No,1,145,4,141,136,7,129
6,Middle,Female,White,Yes,0,305,17,288,275,7,268
6,Middle,Female,White,Yes,1,5,0,5,8,0,8
6,Middle,Male,Black,No,0,2236,46,2190,2344,65,2279
6,Middle,Male,Black,No,1,345,3,342,437,6,431
6,Middle,Male,Black,Yes,0,1083,22,1061,1016,37,979
6,Middle,Male,Black,Yes,1,70,1,69,44,0,44
6,Middle,Male,Hispanic,No,0,295,12,283,384,14,370
6,Middle,Male,Hispanic,No,1,200,4,196,146,4,142
6,Middle,Male,Hispanic,Yes,0,195,13,182,160,10,150
6,Middle,Male,Hispanic,Yes,1,55,4,51,112,9,103
6,Middle,Male,Other,No,0,331,19,312,319,16,303
6,Middle,Male,Other,No,1,555,37,518,480,9,471
6,Middle,Male,Other,Yes,0,100,6,94,76,6,70
6,Middle,Male,Other,Yes,1,55,2,53,56,5,51
6,Middle,Male,White,No,0,1498,50,1448,1170,57,1113
6,Middle,Male,White,No,1,160,8,152,186,12,174
6,Middle,Male,White,Yes,0,600,38,562,634,41,593
6,Middle,Male,White,Yes,1,15,0,15,4,0,4
6,Other,Female,Black,No,0,2495,235,2260,2259,197,2062
6,Other,Female,Black,No,1,187,11,176,113,8,105
6,Other,Female,Black,Yes,0,341,50,291,290,18,272
6,Other,Female,Black,Yes,1,10,0,10,8,3,5
6,Other,Female,Hispanic,No,0,784,66,718,687,83,604
6,Other,Female,Hispanic,No,1,908,102,806,747,75,672
6,Other,Female,Hispanic,Yes,0,85,9,76,80,7,73
6,Other,Female,Hispanic,Yes,1,205,31,174,162,25,137
6,Other,Female,Other,No,0,306,29,277,339,26,313
6,Other,Female,Other,No,1,226,4,222,164,4,160
6,Other,Female,Other,Yes,0,45,1,44,40,3,37
6,Other,Female,Other,Yes,1,10,0,10,8,0,8
6,Other,Female,White,No,0,737,102,635,695,85,610
6,Other,Female,White,No,1,55,3,52,48,1,47
6,Other,Female,White,Yes,0,155,9,146,186,30,156
6,Other,Female,White,Yes,1,10,0,10,8,2,6
6,Other,Male,Black,No,0,2329,194,2135,2221,202,2019
6,Other,Male,Black,No,1,147,3,144,140,13,127
6,Other,Male,Black,Yes,0,869,81,788,762,97,665
6,Other,Male,Black,Yes,1,20,3,17,32,7,25
6,Other,Male,Hispanic,No,0,665,63,602,569,53,516
6,Other,Male,Hispanic,No,1,915,96,819,739,88,651
6,Other,Male,Hispanic,Yes,0,265,27,238,241,47,194
6,Other,Male,Hispanic,Yes,1,539,57,482,412,63,349
6,Other,Male,Other,No,0,250,24,226,325,26,299
6,Other,Male,Other,No,1,223,8,215,140,6,134
6,Other,Male,Other,Yes,0,130,10,120,120,7,113
6,Other,Male,Other,Yes,1,2,0,2,4,0,4
6,Other,Male,White,No,0,865,93,772,760,64,696
6,Other,Male,White,No,1,27,2,25,40,6,34
6,Other,Male,White,Yes,0,468,50,418,384,43,341
6,Other,Male,White,Yes,1,20,2,18,28,6,22
7,Elementary,Female,Black,No,0,6498,433,6065,7796,457,7339
7,Elementary,Female,Black,No,1,848,37,811,1202,55,1147
7,Elementary,Female,Black,Yes,0,1222,81,1141,1395,100,1295
7,Elementary,Female,Black,Yes,1,40,4,36,35,0,35
7,Elementary,Female,Hispanic,No,0,1040,85,955,1305,106,1199
7,Elementary,Female,Hispanic,No,1,302,22,280,322,30,292
7,Elementary,Female,Hispanic,Yes,0,208,22,186,270,23,247
7,Elementary,Female,Hispanic,Yes,1,104,10,94,135,13,122
7,Elementary,Female,Other,No,0,1543,129,1414,2120,163,1957
7,Elementary,Female,Other,No,1,1102,45,1057,1410,69,1341
7,Elementary,Female,Other,Yes,0,260,31,229,360,42,318
7,Elementary,Female,Other,Yes,1,36,0,36,65,9,56
7,Elementary,Female,White,No,0,3290,192,3098,3898,261,3637
7,Elementary,Female,White,No,1,336,17,319,455,29,426
7,Elementary,Female,White,Yes,0,895,59,836,1014,71,943
7,Elementary,Female,White,Yes,1,20,0,20,20,0,20
7,Elementary,Male,Black,No,0,5952,339,5613,7184,424,6760
7,Elementary,Male,Black,No,1,851,44,807,1170,63,1107
7,Elementary,Male,Black,Yes,0,2530,227,2303,3212,236,2976
7,Elementary,Male,Black,Yes,1,124,8,116,136,14,122
7,Elementary,Male,Hispanic,No,0,984,55,929,1259,95,1164
7,Elementary,Male,Hispanic,No,1,319,21,298,398,25,373
7,Elementary,Male,Hispanic,Yes,0,356,42,314,504,58,446
7,Elementary,Male,Hispanic,Yes,1,139,14,125,155,21,134
7,Elementary,Male,Other,No,0,1410,98,1312,1953,142,1811
7,Elementary,Male,Other,No,1,1264,81,1183,1720,49,1671
7,Elementary,Male,Other,Yes,0,490,36,454,710,63,647
7,Elementary,Male,Other,Yes,1,84,10,74,95,10,85
7,Elementary,Male,White,No,0,2772,175,2597,3235,213,3022
7,Elementary,Male,White,No,1,364,30,334,530,36,494
7,Elementary,Male,White,Yes,0,1616,139,1477,1850,148,1702
7,Elementary,Male,White,Yes,1,36,3,33,55,5,50
7,High,Female,Black,No,0,3248,213,3035,4045,374,3671
7,High,Female,Black,No,1,491,27,464,733,21,712
7,High,Female,Black,Yes,0,700,57,643,853,81,772
7,High,Female,Black,Yes,1,52,1,51,70,4,66
7,High,Female,Hispanic,No,0,557,45,512,668,81,587
7,High,Female,Hispanic,No,1,315,45,270,445,59,386
7,High,Female,Hispanic,Yes,0,84,26,58,95,9,86
7,High,Female,Hispanic,Yes,1,88,15,73,90,8,82
7,High,Female,Other,No,0,328,35,293,395,36,359
7,High,Female,Other,No,1,777,50,727,961,50,911
7,High,Female,Other,Yes,0,52,4,48,55,4,51
7,High,Female,Other,Yes,1,20,4,16,25,1,24
7,High,Female,White,No,0,1551,145,1406,1862,128,1734
7,High,Female,White,No,1,176,18,158,225,20,205
7,High,Female,White,Yes,0,420,42,378,411,49,362
7,High,Male,Black,No,0,2927,210,2717,3217,269,2948
7,High,Male,Black,No,1,511,24,487,712,33,679
7,High,Male,Black,Yes,0,1188,99,1089,1416,175,1241
7,High,Male,Black,Yes,1,59,8,51,80,1,79
7,High,Male,Hispanic,No,0,380,40,340,375,27,348
7,High,Male,Hispanic,No,1,394,60,334,466,46,420
7,High,Male,Hispanic,Yes,0,120,10,110,140,17,123
7,High,Male,Hispanic,Yes,1,158,25,133,215,30,185
7,High,Male,Other,No,0,231,8,223,325,24,301
7,High,Male,Other,No,1,819,56,763,974,55,919
7,High,Male,Other,Yes,0,128,12,116,145,10,135
7,High,Male,Other,Yes,1,24,2,22,40,0,40
7,High,Male,White,No,0,1198,70,1128,1530,129,1401
7,High,Male,White,No,1,208,18,190,256,18,238
7,High,Male,White,Yes,0,516,71,445,552,57,495
7,High,Male,White,Yes,1,8,0,8,5,0,5
7,Middle,Female,Black,No,0,2021,43,1978,3213,63,3150
7,Middle,Female,Black,No,1,299,8,291,541,22,519
7,Middle,Female,Black,Yes,0,357,10,347,537,43,494
7,Middle,Female,Black,Yes,1,28,1,27,55,5,50
7,Middle,Female,Hispanic,No,0,324,9,315,500,19,481
7,Middle,Female,Hispanic,No,1,172,10,162,247,9,238
7,Middle,Female,Hispanic,Yes,0,44,3,41,100,16,84
7,Middle,Female,Hispanic,Yes,1,40,4,36,80,6,74
7,Middle,Female,Other,No,0,272,11,261,355,6,349
7,Middle,Female,Other,No,1,418,7,411,618,10,608
7,Middle,Female,Other,Yes,0,60,3,57,65,8,57
7,Middle,Female,Other,Yes,1,8,0,8,5,0,5
7,Middle,Female,White,No,0,1182,50,1132,1540,32,1508
7,Middle,Female,White,No,1,117,5,112,170,6,164
7,Middle,Female,White,Yes,0,244,11,233,345,8,337
7,Middle,Female,White,Yes,1,4,0,4,10,0,10
7,Middle,Male,Black,No,0,1790,33,1757,2926,57,2869
7,Middle,Male,Black,No,1,275,3,272,550,9,541
7,Middle,Male,Black,Yes,0,872,16,856,1270,45,1225
7,Middle,Male,Black,Yes,1,56,1,55,55,0,55
7,Middle,Male,Hispanic,No,0,240,7,233,480,15,465
7,Middle,Male,Hispanic,No,1,160,1,159,185,2,183
7,Middle,Male,Hispanic,Yes,0,156,8,148,201,6,195
7,Middle,Male,Hispanic,Yes,1,44,1,43,140,9,131
7,Middle,Male,Other,No,0,264,15,249,395,10,385
7,Middle,Male,Other,No,1,444,11,433,602,14,588
7,Middle,Male,Other,Yes,0,80,5,75,95,4,91
7,Middle,Male,Other,Yes,1,44,1,43,71,3,68
7,Middle,Male,White,No,0,1200,48,1152,1460,61,1399
7,Middle,Male,White,No,1,129,2,127,235,5,230
7,Middle,Male,White,Yes,0,482,25,457,797,38,759
7,Middle,Male,White,Yes,1,12,0,12,5,0,5
7,Other,Female,Black,No,0,1988,218,1770,2824,249,2575
7,Other,Female,Black,No,1,152,4,148,150,11,139
7,Other,Female,Black,Yes,0,270,41,229,368,29,339
7,Other,Female,Black,Yes,1,8,0,8,10,1,9
7,Other,Female,Hispanic,No,0,624,72,552,865,95,770
7,Other,Female,Hispanic,No,1,724,87,637,935,96,839
7,Other,Female,Hispanic,Yes,0,68,10,58,100,9,91
7,Other,Female,Hispanic,Yes,1,164,24,140,205,30,175
7,Other,Female,Other,No,0,246,18,228,420,36,384
7,Other,Female,Other,No,1,188,5,183,204,5,199
7,Other,Female,Other,Yes,0,36,1,35,50,7,43
7,Other,Female,Other,Yes,1,8,0,8,10,0,10
7,Other,Female,White,No,0,592,79,513,874,100,774
7,Other,Female,White,No,1,44,2,42,60,3,57
7,Other,Female,White,Yes,0,121,11,110,243,38,205
7,Other,Female,White,Yes,1,8,2,6,10,1,9
7,Other,Male,Black,No,0,1872,180,1692,2778,253,2525
7,Other,Male,Black,No,1,120,2,118,180,11,169
7,Other,Male,Black,Yes,0,705,62,643,947,113,834
7,Other,Male,Black,Yes,1,16,1,15,40,10,30
7,Other,Male,Hispanic,No,0,528,55,473,728,69,659
7,Other,Male,Hispanic,No,1,732,79,653,930,108,822
7,Other,Male,Hispanic,Yes,0,209,36,173,301,49,252
7,Other,Male,Hispanic,Yes,1,432,50,382,524,58,466
7,Other,Male,Other,No,0,200,18,182,407,27,380
7,Other,Male,Other,No,1,188,5,183,175,7,168
7,Other,Male,Other,Yes,0,104,6,98,150,10,140
7,Other,Male,Other,Yes,1,4,0,4,5,0,5
7,Other,Male,White,No,0,692,95,597,952,68,884
7,Other,Male,White,No,1,20,0,20,50,9,41
7,Other,Male,White,Yes,0,382,55,327,480,62,418
7,Other,Male,White,Yes,1,16,2,14,35,9,26
8,Elementary,Female,Black,No,0,8157,508,7649,7814,478,7336
8,Elementary,Female,Black,No,1,1072,57,1015,1225,72,1153
8,Elementary,Female,Black,Yes,0,1536,131,1405,1390,96,1294
8,Elementary,Female,Black,Yes,1,50,1,49,35,0,35
8,Elementary,Female,Hispanic,No,0,1305,84,1221,1298,124,1174
8,Elementary,Female,Hispanic,No,1,379,25,354,325,28,297
8,Elementary,Female,Hispanic,Yes,0,260,24,236,270,30,240
8,Elementary,Female,Hispanic,Yes,1,134,13,121,135,17,118
8,Elementary,Female,Other,No,0,1932,138,1794,2129,153,1976
8,Elementary,Female,Other,No,1,1389,70,1319,1410,146,1264
8,Elementary,Female,Other,Yes,0,326,27,299,360,35,325
8,Elementary,Female,Other,Yes,1,45,1,44,65,7,58
8,Elementary,Female,White,No,0,4114,265,3849,3908,248,3660
8,Elementary,Female,White,No,1,420,25,395,455,14,441
8,Elementary,Female,White,Yes,0,1120,88,1032,1019,79,940
8,Elementary,Female,White,Yes,1,25,0,25,20,0,20
8,Elementary,Male,Black,No,0,7468,461,7007,7217,390,6827
8,Elementary,Male,Black,No,1,1086,53,1033,1179,60,1119
8,Elementary,Male,Black,Yes,0,3169,247,2922,3226,236,2990
8,Elementary,Male,Black,Yes,1,155,8,147,135,12,123
8,Elementary,Male,Hispanic,No,0,1231,90,1141,1265,90,1175
8,Elementary,Male,Hispanic,No,1,399,29,370,405,37,368
8,Elementary,Male,Hispanic,Yes,0,445,45,400,502,60,442
8,Elementary,Male,Hispanic,Yes,1,172,13,159,155,13,142
8,Elementary,Male,Other,No,0,1758,127,1631,1950,179,1771
8,Elementary,Male,Other,No,1,1582,99,1483,1721,138,1583
8,Elementary,Male,Other,Yes,0,617,50,567,715,58,657
8,Elementary,Male,Other,Yes,1,105,2,103,95,15,80
8,Elementary,Male,White,No,0,3472,241,3231,3248,236,3012
8,Elementary,Male,White,No,1,455,27,428,531,20,511
8,Elementary,Male,White,Yes,0,2031,164,1867,1850,157,1693
8,Elementary,Male,White,Yes,1,47,3,44,55,8,47
8,High,Female,Black,No,0,4046,274,3772,4057,349,3708
8,High,Female,Black,No,1,610,32,578,739,18,721
8,High,Female,Black,Yes,0,872,76,796,850,85,765
8,High,Female,Black,Yes,1,65,0,65,70,1,69
8,High,Female,Hispanic,No,0,693,62,631,667,55,612
8,High,Female,Hispanic,No,1,390,36,354,453,52,401
8,High,Female,Hispanic,Yes,0,105,22,83,95,13,82
8,High,Female,Hispanic,Yes,1,109,17,92,90,13,77
8,High,Female,Other,No,0,410,39,371,393,24,369
8,High,Female,Other,No,1,965,50,915,963,84,879
8,High,Female,Other,Yes,0,65,12,53,55,2,53
8,High,Female,Other,Yes,1,25,4,21,27,2,25
8,High,Female,White,No,0,1939,155,1784,1866,154,1712
8,High,Female,White,No,1,220,17,203,225,14,211
8,High,Female,White,Yes,0,533,47,486,411,50,361
8,High,Male,Black,No,0,3650,251,3399,3218,220,2998
8,High,Male,Black,No,1,640,21,619,715,23,692
8,High,Male,Black,Yes,0,1468,94,1374,1414,181,1233
8,High,Male,Black,Yes,1,70,5,65,80,0,80
8,High,Male,Hispanic,No,0,470,47,423,382,25,357
8,High,Male,Hispanic,No,1,500,62,438,462,61,401
8,High,Male,Hispanic,Yes,0,145,13,132,142,21,121
8,High,Male,Hispanic,Yes,1,200,34,166,215,30,185
8,High,Male,Other,No,0,290,8,282,325,30,295
8,High,Male,Other,No,1,1023,77,946,966,84,882
8,High,Male,Other,Yes,0,160,14,146,145,13,132
8,High,Male,Other,Yes,1,30,0,30,40,1,39
8,High,Male,White,No,0,1505,95,1410,1536,114,1422
8,High,Male,White,No,1,260,18,242,260,22,238
8,High,Male,White,Yes,0,645,67,578,555,73,482
8,High,Male,White,Yes,1,10,0,10,5,0,5
8,Middle,Female,Black,No,0,2530,62,2468,3217,66,3151
8,Middle,Female,Black,No,1,368,12,356,546,17,529
8,Middle,Female,Black,Yes,0,450,22,428,535,25,510
8,Middle,Female,Black,Yes,1,35,0,35,55,5,50
8,Middle,Female,Hispanic,No,0,405,8,397,500,12,488
8,Middle,Female,Hispanic,No,1,221,8,213,245,7,238
8,Middle,Female,Hispanic,Yes,0,55,2,53,95,8,87
8,Middle,Female,Hispanic,Yes,1,50,3,47,80,4,76
8,Middle,Female,Other,No,0,340,8,332,355,14,341
8,Middle,Female,Other,No,1,520,5,515,613,16,597
8,Middle,Female,Other,Yes,0,75,6,69,65,8,57
8,Middle,Female,Other,Yes,1,10,1,9,5,0,5
8,Middle,Female,White,No,0,1482,52,1430,1544,31,1513
8,Middle,Female,White,No,1,149,4,145,170,5,165
8,Middle,Female,White,Yes,0,303,15,288,345,13,332
8,Middle,Female,White,Yes,1,5,0,5,10,0,10
8,Middle,Male,Black,No,0,2234,51,2183,2927,61,2866
8,Middle,Male,Black,No,1,346,4,342,547,10,537
8,Middle,Male,Black,Yes,0,1093,30,1063,1270,38,1232
8,Middle,Male,Black,Yes,1,70,1,69,55,0,55
8,Middle,Male,Hispanic,No,0,300,12,288,483,19,464
8,Middle,Male,Hispanic,No,1,205,10,195,183,1,182
8,Middle,Male,Hispanic,Yes,0,200,12,188,205,14,191
8,Middle,Male,Hispanic,Yes,1,55,4,51,140,12,128
8,Middle,Male,Other,No,0,330,16,314,395,16,379
8,Middle,Male,Other,No,1,560,21,539,610,27,583
8,Middle,Male,Other,Yes,0,100,2,98,95,6,89
8,Middle,Male,Other,Yes,1,55,2,53,75,4,71
8,Middle,Male,White,No,0,1499,69,1430,1460,69,1391
8,Middle,Male,White,No,1,164,0,164,235,4,231
8,Middle,Male,White,Yes,0,607,26,581,800,38,762
8,Middle,Male,White,Yes,1,15,0,15,5,0,5
8,Other,Female,Black,No,0,2489,240,2249,2842,255,2587
8,Other,Female,Black,No,1,190,4,186,150,4,146
8,Other,Female,Black,Yes,0,335,56,279,365,36,329
8,Other,Female,Black,Yes,1,10,1,9,10,1,9
8,Other,Female,Hispanic,No,0,779,89,690,870,108,762
8,Other,Female,Hispanic,No,1,903,107,796,930,95,835
8,Other,Female,Hispanic,Yes,0,85,8,77,103,8,95
8,Other,Female,Hispanic,Yes,1,205,37,168,205,30,175
8,Other,Female,Other,No,0,307,36,271,422,31,391
8,Other,Female,Other,No,1,235,3,232,208,19,189
8,Other,Female,Other,Yes,0,45,2,43,50,5,45
8,Other,Female,Other,Yes,1,10,0,10,10,2,8
8,Other,Female,White,No,0,740,93,647,880,94,786
8,Other,Female,White,No,1,55,2,53,60,3,57
8,Other,Female,White,Yes,0,150,14,136,240,36,204
8,Other,Female,White,Yes,1,10,0,10,10,2,8
8,Other,Male,Black,No,0,2354,201,2153,2771,219,2552
8,Other,Male,Black,No,1,150,3,147,194,12,182
8,Other,Male,Black,Yes,0,895,101,794,957,110,847
8,Other,Male,Black,Yes,1,20,1,19,35,5,30
8,Other,Male,Hispanic,No,0,662,69,593,730,71,659
8,Other,Male,Hispanic,No,1,920,91,829,926,113,813
8,Other,Male,Hispanic,Yes,0,255,39,216,300,54,246
8,Other,Male,Hispanic,Yes,1,540,53,487,520,70,450
8,Other,Male,Other,No,0,250,32,218,409,18,391
8,Other,Male,Other,No,1,235,8,227,175,14,161
8,Other,Male,Other,Yes,0,128,11,117,150,16,134
8,Other,Male,Other,Yes,1,5,0,5,5,0,5
8,Other,Male,White,No,0,865,96,769,956,81,875
8,Other,Male,White,No,1,25,0,25,54,7,47
8,Other,Male,White,Yes,0,479,62,417,478,61,417
8,Other,Male,White,Yes,1,20,4,16,35,6,29
9,Elementary,Female,Black,No,0,8181,498,7683,6266,762,5504
9,Elementary,Female,Black,No,1,1079,35,1044,1002,83,919
9,Elementary,Female,Black,Yes,0,1539,120,1419,1112,135,977
9,Elementary,Female,Black,Yes,1,50,3,47,28,1,27
9,Elementary,Female,Hispanic,No,0,1305,76,1229,1037,157,880
9,Elementary,Female,Hispanic,No,1,380,22,358,262,37,225
9,Elementary,Female,Hispanic,Yes,0,260,20,240,216,38,178
9,Elementary,Female,Hispanic,Yes,1,135,18,117,108,22,86
9,Elementary,Female,Other,No,0,1934,148,1786,1712,207,1505
9,Elementary,Female,Other,No,1,1392,71,1321,1132,77,1055
9,Elementary,Female,Other,Yes,0,330,24,306,288,46,242
9,Elementary,Female,Other,Yes,1,45,1,44,52,4,48
9,Elementary,Female,White,No,0,4114,299,3815,3126,363,2763
9,Elementary,Female,White,No,1,420,24,396,364,40,324
9,Elementary,Female,White,Yes,0,1126,79,1047,816,89,727
9,Elementary,Female,White,Yes,1,25,0,25,16,0,16
9,Elementary,Male,Black,No,0,7463,402,7061,5798,685,5113
9,Elementary,Male,Black,No,1,1090,58,1032,954,76,878
9,Elementary,Male,Black,Yes,0,3167,251,2916,2577,343,2234
9,Elementary,Male,Black,Yes,1,155,5,150,108,10,98
9,Elementary,Male,Hispanic,No,0,1235,88,1147,1012,142,870
9,Elementary,Male,Hispanic,No,1,400,25,375,325,67,258
9,Elementary,Male,Hispanic,Yes,0,447,50,397,404,76,328
9,Elementary,Male,Hispanic,Yes,1,175,22,153,122,28,94
9,Elementary,Male,Other,No,0,1743,125,1618,1558,217,1341
9,Elementary,Male,Other,No,1,1590,97,1493,1376,77,1299
9,Elementary,Male,Other,Yes,0,620,40,580,576,77,499
9,Elementary,Male,Other,Yes,1,105,10,95,76,14,62
9,Elementary,Male,White,No,0,3476,254,3222,2587,293,2294
9,Elementary,Male,White,No,1,461,31,430,428,67,361
9,Elementary,Male,White,Yes,0,2035,166,1869,1474,164,1310
9,Elementary,Male,White,Yes,1,50,4,46,44,8,36
9,High,Female,Black,No,0,4037,344,3693,3235,400,2835
9,High,Female,Black,No,1,598,36,562,599,32,567
9,High,Female,Black,Yes,0,865,76,789,682,103,579
9,High,Female,Black,Yes,1,65,3,62,56,4,52
9,High,Female,Hispanic,No,0,697,77,620,536,84,452
9,High,Female,Hispanic,No,1,387,49,338,365,69,296
9,High,Female,Hispanic,Yes,0,100,28,72,76,10,66
9,High,Female,Hispanic,Yes,1,101,17,84,71,13,58
9,High,Female,Other,No,0,410,41,369,316,29,287
9,High,Female,Other,No,1,965,83,882,773,61,712
9,High,Female,Other,Yes,0,65,5,60,44,6,38
9,High,Female,Other,Yes,1,23,3,20,22,0,22
9,High,Female,White,No,0,1931,187,1744,1496,181,1315
9,High,Female,White,No,1,220,23,197,180,17,163
9,High,Female,White,Yes,0,535,70,465,327,51,276
9,High,Male,Black,No,0,3660,285,3375,2576,301,2275
9,High,Male,Black,No,1,630,35,595,579,41,538
9,High,Male,Black,Yes,0,1464,129,1335,1127,191,936
9,High,Male,Black,Yes,1,64,5,59,62,2,60
9,High,Male,Hispanic,No,0,466,57,409,310,32,278
9,High,Male,Hispanic,No,1,498,66,432,369,60,309
9,High,Male,Hispanic,Yes,0,145,17,128,116,16,100
9,High,Male,Hispanic,Yes,1,205,35,170,172,27,145
9,High,Male,Other,No,0,290,13,277,262,28,234
9,High,Male,Other,No,1,1030,118,912,770,79,691
9,High,Male,Other,Yes,0,165,17,148,116,9,107
9,High,Male,Other,Yes,1,30,2,28,32,1,31
9,High,Male,White,No,0,1517,125,1392,1227,132,1095
9,High,Male,White,No,1,261,29,232,207,22,185
9,High,Male,White,Yes,0,649,85,564,443,59,384
9,High,Male,White,Yes,1,10,1,9,4,0,4
9,Middle,Female,Black,No,0,2533,55,2478,2577,125,2452
9,Middle,Female,Black,No,1,369,9,360,446,21,425
9,Middle,Female,Black,Yes,0,450,8,442,428,37,391
9,Middle,Female,Black,Yes,1,35,2,33,44,5,39
9,Middle,Female,Hispanic,No,0,408,12,396,400,18,382
9,Middle,Female,Hispanic,No,1,231,7,224,195,10,185
9,Middle,Female,Hispanic,Yes,0,55,4,51,76,9,67
9,Middle,Female,Hispanic,Yes,1,50,0,50,64,8,56
9,Middle,Female,Other,No,0,337,16,321,284,10,274
9,Middle,Female,Other,No,1,520,9,511,488,14,474
9,Middle,Female,Other,Yes,0,75,1,74,52,11,41
9,Middle,Female,Other,Yes,1,10,1,9,4,0,4
9,Middle,Female,White,No,0,1480,63,1417,1242,60,1182
9,Middle,Female,White,No,1,150,6,144,136,3,133
9,Middle,Female,White,Yes,0,298,9,289,276,26,250
9,Middle,Female,White,Yes,1,5,0,5,8,1,7
9,Middle,Male,Black,No,0,2229,28,2201,2341,107,2234
9,Middle,Male,Black,No,1,355,3,352,448,15,433
9,Middle,Male,Black,Yes,0,1095,18,1077,1014,70,944
9,Middle,Male,Black,Yes,1,70,1,69,44,1,43
9,Middle,Male,Hispanic,No,0,300,12,288,386,41,345
9,Middle,Male,Hispanic,No,1,205,5,200,148,12,136
9,Middle,Male,Hispanic,Yes,0,200,9,191,164,15,149
9,Middle,Male,Hispanic,Yes,1,55,4,51,114,14,100
9,Middle,Male,Other,No,0,321,15,306,316,16,300
9,Middle,Male,Other,No,1,565,21,544,488,7,481
9,Middle,Male,Other,Yes,0,100,1,99,76,5,71
9,Middle,Male,Other,Yes,1,55,3,52,60,2,58
9,Middle,Male,White,No,0,1494,51,1443,1165,75,1090
9,Middle,Male,White,No,1,165,1,164,188,11,177
9,Middle,Male,White,Yes,0,605,22,583,636,55,581
9,Middle,Male,White,Yes,1,15,1,14,4,0,4
9,Other,Female,Black,No,0,2498,237,2261,2278,268,2010
9,Other,Female,Black,No,1,190,9,181,120,11,109
9,Other,Female,Black,Yes,0,331,57,274,308,43,265
9,Other,Female,Black,Yes,1,10,0,10,8,0,8
9,Other,Female,Hispanic,No,0,780,76,704,704,118,586
9,Other,Female,Hispanic,No,1,897,107,790,740,123,617
9,Other,Female,Hispanic,Yes,0,85,9,76,84,14,70
9,Other,Female,Hispanic,Yes,1,207,30,177,164,41,123
9,Other,Female,Other,No,0,310,23,287,338,38,300
9,Other,Female,Other,No,1,235,3,232,168,3,165
9,Other,Female,Other,Yes,0,45,3,42,40,7,33
9,Other,Female,Other,Yes,1,10,1,9,8,0,8
9,Other,Female,White,No,0,736,106,630,701,80,621
9,Other,Female,White,No,1,55,4,51,48,2,46
9,Other,Female,White,Yes,0,155,13,142,192,32,160
9,Other,Female,White,Yes,1,10,1,9,8,4,4
9,Other,Male,Black,No,0,2379,216,2163,2225,236,1989
9,Other,Male,Black,No,1,150,4,146,156,8,148
9,Other,Male,Black,Yes,0,899,101,798,768,123,645
9,Other,Male,Black,Yes,1,20,1,19,30,3,27
9,Other,Male,Hispanic,No,0,663,68,595,582,88,494
9,Other,Male,Hispanic,No,1,925,94,831,740,154,586
9,Other,Male,Hispanic,Yes,0,254,42,212,240,60,180
9,Other,Male,Hispanic,Yes,1,545,78,467,416,83,333
9,Other,Male,Other,No,0,250,25,225,328,29,299
9,Other,Male,Other,No,1,235,4,231,140,5,135
9,Other,Male,Other,Yes,0,130,7,123,120,12,108
9,Other,Male,Other,Yes,1,5,0,5,4,0,4
9,Other,Male,White,No,0,865,98,767,769,72,697
9,Other,Male,White,No,1,25,0,25,44,9,35
9,Other,Male,White,Yes,0,472,64,408,391,67,324
9,Other,Male,White,Yes,1,20,1,19,28,5,23
10,Elementary,Female,Black,No,0,8152,820,7332,6270,451,5819
10,Elementary,Female,Black,No,1,1082,87,995,1015,56,959
10,Elementary,Female,Black,Yes,0,1536,202,1334,1108,83,1025
10,Elementary,Female,Black,Yes,1,50,7,43,28,1,27
10,Elementary,Female,Hispanic,No,0,1310,149,1161,1029,75,954
10,Elementary,Female,Hispanic,No,1,378,59,319,260,20,240
10,Elementary,Female,Hispanic,Yes,0,260,33,227,217,22,195
10,Elementary,Female,Hispanic,Yes,1,135,23,112,108,10,98
10,Elementary,Female,Other,No,0,1945,214,1731,1721,119,1602
10,Elementary,Female,Other,No,1,1390,68,1322,1132,57,1075
10,Elementary,Female,Other,Yes,0,328,42,286,286,34,252
10,Elementary,Female,Other,Yes,1,45,3,42,52,7,45
10,Elementary,Female,White,No,0,4094,387,3707,3102,219,2883
10,Elementary,Female,White,No,1,420,56,364,364,14,350
10,Elementary,Female,White,Yes,0,1130,115,1015,816,60,756
10,Elementary,Female,White,Yes,1,25,1,24,16,1,15
10,Elementary,Male,Black,No,0,7474,787,6687,5801,355,5446
10,Elementary,Male,Black,No,1,1096,77,1019,953,48,905
10,Elementary,Male,Black,Yes,0,3173,416,2757,2571,181,2390
10,Elementary,Male,Black,Yes,1,155,11,144,108,6,102
10,Elementary,Male,Hispanic,No,0,1235,151,1084,1006,69,937
10,Elementary,Male,Hispanic,No,1,400,41,359,324,23,301
10,Elementary,Male,Hispanic,Yes,0,450,72,378,399,52,347
10,Elementary,Male,Hispanic,Yes,1,175,34,141,120,15,105
10,Elementary,Male,Other,No,0,1742,205,1537,1557,117,1440
10,Elementary,Male,Other,No,1,1595,88,1507,1370,59,1311
10,Elementary,Male,Other,Yes,0,622,80,542,576,43,533
10,Elementary,Male,Other,Yes,1,105,4,101,76,7,69
10,Elementary,Male,White,No,0,3455,351,3104,2577,168,2409
10,Elementary,Male,White,No,1,465,68,397,429,15,414
10,Elementary,Male,White,Yes,0,2029,235,1794,1468,119,1349
10,Elementary,Male,White,Yes,1,50,3,47,44,2,42
10,High,Female,Black,No,0,4017,427,3590,3229,258,2971
10,High,Female,Black,No,1,593,40,553,617,22,595
10,High,Female,Black,Yes,0,864,117,747,681,71,610
10,High,Female,Black,Yes,1,65,0,65,56,2,54
10,High,Female,Hispanic,No,0,692,100,592,534,50,484
10,High,Female,Hispanic,No,1,384,74,310,362,59,303
10,High,Female,Hispanic,Yes,0,98,18,80,76,10,66
10,High,Female,Hispanic,Yes,1,100,18,82,69,7,62
10,High,Female,Other,No,0,409,59,350,316,23,293
10,High,Female,Other,No,1,966,62,904,780,42,738
10,High,Female,Other,Yes,0,65,5,60,44,9,35
10,High,Female,Other,Yes,1,22,1,21,22,0,22
10,High,Female,White,No,0,1921,237,1684,1489,112,1377
10,High,Female,White,No,1,220,27,193,180,12,168
10,High,Female,White,Yes,0,539,58,481,328,44,284
10,High,Male,Black,No,0,3644,438,3206,2574,182,2392
10,High,Male,Black,No,1,633,53,580,589,12,577
10,High,Male,Black,Yes,0,1465,177,1288,1121,135,986
10,High,Male,Black,Yes,1,60,2,58,60,0,60
10,High,Male,Hispanic,No,0,463,68,395,315,28,287
10,High,Male,Hispanic,No,1,492,75,417,364,49,315
10,High,Male,Hispanic,Yes,0,144,28,116,114,11,103
10,High,Male,Hispanic,Yes,1,205,39,166,168,19,149
10,High,Male,Other,No,0,288,23,265,264,15,249
10,High,Male,Other,No,1,1031,110,921,764,37,727
10,High,Male,Other,Yes,0,163,14,149,116,7,109
10,High,Male,Other,Yes,1,34,5,29,32,0,32
10,High,Male,White,No,0,1521,175,1346,1226,113,1113
10,High,Male,White,No,1,264,33,231,212,19,193
10,High,Male,White,Yes,0,644,108,536,442,47,395
10,High,Male,White,Yes,1,10,1,9,4,0,4
10,Middle,Female,Black,No,0,2537,85,2452,2565,59,2506
10,Middle,Female,Black,No,1,378,13,365,445,13,432
10,Middle,Female,Black,Yes,0,450,26,424,428,17,411
10,Middle,Female,Black,Yes,1,35,2,33,44,2,42
10,Middle,Female,Hispanic,No,0,410,21,389,402,15,387
10,Middle,Female,Hispanic,No,1,235,17,218,192,3,189
10,Middle,Female,Hispanic,Yes,0,55,4,51,75,5,70
10,Middle,Female,Hispanic,Yes,1,50,3,47,64,4,60
10,Middle,Female,Other,No,0,333,7,326,284,7,277
10,Middle,Female,Other,No,1,515,10,505,488,7,481
10,Middle,Female,Other,Yes,0,75,6,69,49,4,45
10,Middle,Female,Other,Yes,1,10,0,10,4,0,4
10,Middle,Female,White,No,0,1478,73,1405,1244,41,1203
10,Middle,Female,White,No,1,150,10,140,136,2,134
10,Middle,Female,White,Yes,0,295,16,279,272,17,255
10,Middle,Female,White,Yes,1,5,1,4,8,0,8
10,Middle,Male,Black,No,0,2238,63,2175,2332,59,2273
10,Middle,Male,Black,No,1,354,5,349,452,10,442
10,Middle,Male,Black,Yes,0,1095,42,1053,1010,41,969
10,Middle,Male,Black,Yes,1,70,3,67,44,1,43
10,Middle,Male,Hispanic,No,0,300,17,283,385,14,371
10,Middle,Male,Hispanic,No,1,205,14,191,148,0,148
10,Middle,Male,Hispanic,Yes,0,200,13,187,164,16,148
10,Middle,Male,Hispanic,Yes,1,55,6,49,116,16,100
10,Middle,Male,Other,No,0,320,27,293,316,14,302
10,Middle,Male,Other,No,1,565,18,547,484,9,475
10,Middle,Male,Other,Yes,0,100,5,95,76,8,68
10,Middle,Male,Other,Yes,1,55,3,52,60,1,59
10,Middle,Male,White,No,0,1489,79,1410,1167,55,1112
10,Middle,Male,White,No,1,167,6,161,188,8,180
10,Middle,Male,White,Yes,0,606,45,561,638,44,594
10,Middle,Male,White,Yes,1,15,1,14,4,0,4
10,Other,Female,Black,No,0,2436,261,2175,2276,277,1999
10,Other,Female,Black,No,1,190,5,185,120,16,104
10,Other,Female,Black,Yes,0,320,51,269,322,33,289
10,Other,Female,Black,Yes,1,10,1,9,8,0,8
10,Other,Female,Hispanic,No,0,766,91,675,701,73,628
10,Other,Female,Hispanic,No,1,895,130,765,740,51,689
10,Other,Female,Hispanic,Yes,0,87,13,74,84,13,71
10,Other,Female,Hispanic,Yes,1,211,42,169,164,32,132
10,Other,Female,Other,No,0,309,34,275,336,37,299
10,Other,Female,Other,No,1,235,8,227,168,0,168
10,Other,Female,Other,Yes,0,45,3,42,40,3,37
10,Other,Female,Other,Yes,1,10,0,10,8,0,8
10,Other,Female,White,No,0,712,82,630,698,108,590
10,Other,Female,White,No,1,55,6,49,48,4,44
10,Other,Female,White,Yes,0,153,24,129,192,30,162
10,Other,Female,White,Yes,1,10,2,8,8,3,5
10,Other,Male,Black,No,0,2352,223,2129,2223,216,2007
10,Other,Male,Black,No,1,150,6,144,156,7,149
10,Other,Male,Black,Yes,0,888,114,774,773,107,666
10,Other,Male,Black,Yes,1,20,2,18,32,6,26
10,Other,Male,Hispanic,No,0,657,82,575,578,71,507
10,Other,Male,Hispanic,No,1,921,135,786,736,80,656
10,Other,Male,Hispanic,Yes,0,248,46,202,240,30,210
10,Other,Male,Hispanic,Yes,1,551,99,452,416,54,362
10,Other,Male,Other,No,0,248,28,220,324,21,303
10,Other,Male,Other,No,1,235,3,232,136,4,132
10,Other,Male,Other,Yes,0,130,11,119,119,11,108
10,Other,Male,Other,Yes,1,5,0,5,4,0,4
10,Other,Male,White,No,0,851,91,760,772,74,698
10,Other,Male,White,No,1,25,0,25,44,9,35
10,Other,Male,White,Yes,0,466,70,396,394,65,329
10,Other,Male,White,Yes,1,20,1,19,28,3,25
11,Elementary,Female,Black,No,0,6527,400,6127,7843,597,7246
11,Elementary,Female,Black,No,1,872,47,825,1280,48,1232
11,Elementary,Female,Black,Yes,0,1225,107,1118,1384,107,1277
11,Elementary,Female,Black,Yes,1,40,2,38,35,0,35
11,Elementary,Female,Hispanic,No,0,1049,54,995,1286,103,1183
11,Elementary,Female,Hispanic,No,1,304,20,284,323,28,295
11,Elementary,Female,Hispanic,Yes,0,208,26,182,277,38,239
11,Elementary,Female,Hispanic,Yes,1,112,14,98,135,11,124
11,Elementary,Female,Other,No,0,1554,113,1441,2165,182,1983
11,Elementary,Female,Other,No,1,1119,53,1066,1415,103,1312
11,Elementary,Female,Other,Yes,0,260,17,243,360,42,318
11,Elementary,Female,Other,Yes,1,36,0,36,65,7,58
11,Elementary,Female,White,No,0,3276,217,3059,3874,339,3535
11,Elementary,Female,White,No,1,336,23,313,455,15,440
11,Elementary,Female,White,Yes,0,904,79,825,1020,99,921
11,Elementary,Female,White,Yes,1,20,0,20,20,0,20
11,Elementary,Male,Black,No,0,5985,372,5613,7264,500,6764
11,Elementary,Male,Black,No,1,880,44,836,1215,50,1165
11,Elementary,Male,Black,Yes,0,2543,206,2337,3216,263,2953
11,Elementary,Male,Black,Yes,1,124,4,120,135,9,126
11,Elementary,Male,Hispanic,No,0,988,62,926,1256,102,1154
11,Elementary,Male,Hispanic,No,1,320,19,301,407,30,377
11,Elementary,Male,Hispanic,Yes,0,360,36,324,500,54,446
11,Elementary,Male,Hispanic,Yes,1,144,14,130,150,28,122
11,Elementary,Male,Other,No,0,1392,116,1276,1943,162,1781
11,Elementary,Male,Other,No,1,1278,54,1224,1707,114,1593
11,Elementary,Male,Other,Yes,0,502,39,463,720,73,647
11,Elementary,Male,Other,Yes,1,84,7,77,95,11,84
11,Elementary,Male,White,No,0,2754,175,2579,3219,267,2952
11,Elementary,Male,White,No,1,375,23,352,541,38,503
11,Elementary,Male,White,Yes,0,1607,120,1487,1838,151,1687
11,Elementary,Male,White,Yes,1,40,4,36,55,2,53
11,High,Female,Black,No,0,3199,241,2958,4023,360,3663
11,High,Female,Black,No,1,478,21,457,789,24,765
11,High,Female,Black,Yes,0,687,63,624,850,89,761
11,High,Female,Black,Yes,1,53,2,51,70,2,68
11,High,Female,Hispanic,No,0,545,50,495,665,60,605
11,High,Female,Hispanic,No,1,316,30,286,453,74,379
11,High,Female,Hispanic,Yes,0,76,9,67,95,17,78
11,High,Female,Hispanic,Yes,1,80,8,72,90,12,78
11,High,Female,Other,No,0,328,38,290,395,33,362
11,High,Female,Other,No,1,775,47,728,979,91,888
11,High,Female,Other,Yes,0,52,2,50,55,4,51
11,High,Female,Other,Yes,1,20,3,17,27,1,26
11,High,Female,White,No,0,1523,145,1378,1859,151,1708
11,High,Female,White,No,1,174,11,163,225,12,213
11,High,Female,White,Yes,0,429,46,383,402,55,347
11,High,Male,Black,No,0,2893,212,2681,3221,229,2992
11,High,Male,Black,No,1,503,26,477,740,17,723
11,High,Male,Black,Yes,0,1164,108,1056,1390,179,1211
11,High,Male,Black,Yes,1,48,0,48,75,0,75
11,High,Male,Hispanic,No,0,363,32,331,395,31,364
11,High,Male,Hispanic,No,1,395,41,354,453,45,408
11,High,Male,Hispanic,Yes,0,111,22,89,140,19,121
11,High,Male,Hispanic,Yes,1,163,25,138,210,31,179
11,High,Male,Other,No,0,224,10,214,330,32,298
11,High,Male,Other,No,1,822,63,759,953,98,855
11,High,Male,Other,Yes,0,128,6,122,145,13,132
11,High,Male,Other,Yes,1,28,0,28,40,4,36
11,High,Male,White,No,0,1208,93,1115,1517,122,1395
11,High,Male,White,No,1,211,13,198,265,25,240
11,High,Male,White,Yes,0,500,53,447,547,64,483
11,High,Male,White,Yes,1,8,0,8,5,1,4
11,Middle,Female,Black,No,0,2034,50,1984,3215,98,3117
11,Middle,Female,Black,No,1,304,8,296,550,7,543
11,Middle,Female,Black,Yes,0,363,10,353,535,22,513
11,Middle,Female,Black,Yes,1,28,0,28,55,0,55
11,Middle,Female,Hispanic,No,0,328,14,314,504,25,479
11,Middle,Female,Hispanic,No,1,188,5,183,245,8,237
11,Middle,Female,Hispanic,Yes,0,44,2,42,90,6,84
11,Middle,Female,Hispanic,Yes,1,40,0,40,80,2,78
11,Middle,Female,Other,No,0,268,6,262,355,14,341
11,Middle,Female,Other,No,1,412,4,408,610,24,586
11,Middle,Female,Other,Yes,0,60,2,58,60,5,55
11,Middle,Female,Other,Yes,1,8,0,8,5,0,5
11,Middle,Female,White,No,0,1184,59,1125,1555,66,1489
11,Middle,Female,White,No,1,120,2,118,170,3,167
11,Middle,Female,White,Yes,0,233,13,220,340,19,321
11,Middle,Female,White,Yes,1,4,0,4,10,0,10
11,Middle,Male,Black,No,0,1800,38,1762,2909,64,2845
11,Middle,Male,Black,No,1,285,4,281,575,11,564
11,Middle,Male,Black,Yes,0,880,26,854,1263,55,1208
11,Middle,Male,Black,Yes,1,56,1,55,65,0,65
11,Middle,Male,Hispanic,No,0,239,5,234,482,22,460
11,Middle,Male,Hispanic,No,1,166,1,165,185,9,176
11,Middle,Male,Hispanic,Yes,0,160,5,155,205,9,196
11,Middle,Male,Hispanic,Yes,1,44,0,44,145,9,136
11,Middle,Male,Other,No,0,256,19,237,395,17,378
11,Middle,Male,Other,No,1,452,21,431,605,30,575
11,Middle,Male,Other,Yes,0,80,1,79,95,10,85
11,Middle,Male,Other,Yes,1,44,3,41,75,3,72
11,Middle,Male,White,No,0,1191,42,1149,1456,63,1393
11,Middle,Male,White,No,1,132,3,129,235,7,228
11,Middle,Male,White,Yes,0,492,24,468,802,52,750
11,Middle,Male,White,Yes,1,12,0,12,5,0,5
11,Other,Female,Black,No,0,1906,133,1773,2798,287,2511
11,Other,Female,Black,No,1,156,9,147,150,18,132
11,Other,Female,Black,Yes,0,252,40,212,414,54,360
11,Other,Female,Black,Yes,1,8,0,8,10,1,9
11,Other,Female,Hispanic,No,0,608,55,553,864,100,764
11,Other,Female,Hispanic,No,1,709,72,637,919,81,838
11,Other,Female,Hispanic,Yes,0,72,10,62,105,9,96
11,Other,Female,Hispanic,Yes,1,170,13,157,205,35,170
11,Other,Female,Other,No,0,253,19,234,420,28,392
11,Other,Female,Other,No,1,190,2,188,210,8,202
11,Other,Female,Other,Yes,0,36,0,36,50,5,45
11,Other,Female,Other,Yes,1,8,0,8,10,1,9
11,Other,Female,White,No,0,552,50,502,849,92,757
11,Other,Female,White,No,1,44,7,37,60,0,60
11,Other,Female,White,Yes,0,120,10,110,240,41,199
11,Other,Female,White,Yes,1,8,1,7,10,1,9
11,Other,Male,Black,No,0,1875,144,1731,2725,213,2512
11,Other,Male,Black,No,1,120,3,117,190,6,184
11,Other,Male,Black,Yes,0,694,40,654,936,125,811
11,Other,Male,Black,Yes,1,16,2,14,40,1,39
11,Other,Male,Hispanic,No,0,528,43,485,710,78,632
11,Other,Male,Hispanic,No,1,732,54,678,915,123,792
11,Other,Male,Hispanic,Yes,0,197,22,175,300,39,261
11,Other,Male,Hispanic,Yes,1,444,50,394,515,66,449
11,Other,Male,Other,No,0,196,14,182,400,24,376
11,Other,Male,Other,No,1,192,5,187,170,6,164
11,Other,Male,Other,Yes,0,104,4,100,145,13,132
11,Other,Male,Other,Yes,1,4,0,4,5,0,5
11,Other,Male,White,No,0,672,71,601,968,99,869
11,Other,Male,White,No,1,20,0,20,51,6,45
11,Other,Male,White,Yes,0,370,53,317,499,75,424
11,Other,Male,White,Yes,1,16,2,14,35,8,27
12,Elementary,Female,Black,No,0,8171,1287,6884,6279,951,5328
12,Elementary,Female,Black,No,1,1091,77,1014,1024,68,956
12,Elementary,Female,Black,Yes,0,1533,276,1257,1106,184,922
12,Elementary,Female,Black,Yes,1,50,0,50,28,1,27
12,Elementary,Female,Hispanic,No,0,1313,257,1056,1032,175,857
12,Elementary,Female,Hispanic,No,1,380,75,305,256,51,205
12,Elementary,Female,Hispanic,Yes,0,253,60,193,224,48,176
12,Elementary,Female,Hispanic,Yes,1,138,37,101,108,16,92
12,Elementary,Female,Other,No,0,1937,330,1607,1740,276,1464
12,Elementary,Female,Other,No,1,1405,108,1297,1137,62,1075
12,Elementary,Female,Other,Yes,0,325,61,264,288,49,239
12,Elementary,Female,Other,Yes,1,45,5,40,52,1,51
12,Elementary,Female,White,No,0,4099,550,3549,3110,438,2672
12,Elementary,Female,White,No,1,420,63,357,364,42,322
12,Elementary,Female,White,Yes,0,1125,168,957,816,134,682
12,Elementary,Female,White,Yes,1,25,0,25,16,1,15
12,Elementary,Male,Black,No,0,7503,1136,6367,5814,833,4981
12,Elementary,Male,Black,No,1,1101,94,1007,972,57,915
12,Elementary,Male,Black,Yes,0,3182,572,2610,2572,432,2140
12,Elementary,Male,Black,Yes,1,155,16,139,108,7,101
12,Elementary,Male,Hispanic,No,0,1235,222,1013,1007,163,844
12,Elementary,Male,Hispanic,No,1,400,73,327,328,59,269
12,Elementary,Male,Hispanic,Yes,0,450,83,367,400,91,309
12,Elementary,Male,Hispanic,Yes,1,180,35,145,123,32,91
12,Elementary,Male,Other,No,0,1745,270,1475,1554,263,1291
12,Elementary,Male,Other,No,1,1610,115,1495,1367,83,1284
12,Elementary,Male,Other,Yes,0,626,113,513,576,103,473
12,Elementary,Male,Other,Yes,1,105,10,95,76,8,68
12,Elementary,Male,White,No,0,3436,496,2940,2583,379,2204
12,Elementary,Male,White,No,1,480,72,408,438,70,368
12,Elementary,Male,White,Yes,0,2005,323,1682,1472,234,1238
12,Elementary,Male,White,Yes,1,50,8,42,44,6,38
12,High,Female,Black,No,0,3976,360,3616,3215,359,2856
12,High,Female,Black,No,1,593,34,559,632,20,612
12,High,Female,Black,Yes,0,850,101,749,677,74,603
12,High,Female,Black,Yes,1,69,2,67,56,4,52
12,High,Female,Hispanic,No,0,666,87,579,535,61,474
12,High,Female,Hispanic,No,1,393,76,317,361,72,289
12,High,Female,Hispanic,Yes,0,94,21,73,76,16,60
12,High,Female,Hispanic,Yes,1,98,10,88,72,13,59
12,High,Female,Other,No,0,406,65,341,319,28,291
12,High,Female,Other,No,1,955,61,894,783,57,726
12,High,Female,Other,Yes,0,64,10,54,44,7,37
12,High,Female,Other,Yes,1,25,7,18,23,1,22
12,High,Female,White,No,0,1895,168,1727,1487,137,1350
12,High,Female,White,No,1,206,12,194,180,11,169
12,High,Female,White,Yes,0,521,61,460,321,48,273
12,High,Male,Black,No,0,3568,312,3256,2561,237,2324
12,High,Male,Black,No,1,619,46,573,591,12,579
12,High,Male,Black,Yes,0,1439,167,1272,1108,156,952
12,High,Male,Black,Yes,1,59,0,59,60,0,60
12,High,Male,Hispanic,No,0,436,44,392,314,39,275
12,High,Male,Hispanic,No,1,500,69,431,362,44,318
12,High,Male,Hispanic,Yes,0,128,17,111,112,18,94
12,High,Male,Hispanic,Yes,1,196,36,160,168,19,149
12,High,Male,Other,No,0,280,24,256,260,19,241
12,High,Male,Other,No,1,1011,90,921,760,49,711
12,High,Male,Other,Yes,0,160,12,148,116,20,96
12,High,Male,Other,Yes,1,35,0,35,32,0,32
12,High,Male,White,No,0,1502,113,1389,1214,104,1110
12,High,Male,White,No,1,259,26,233,213,25,188
12,High,Male,White,Yes,0,625,91,534,431,53,378
12,High,Male,White,Yes,1,10,0,10,4,0,4
12,Middle,Female,Black,No,0,2538,124,2414,2575,159,2416
12,Middle,Female,Black,No,1,380,9,371,440,6,434
12,Middle,Female,Black,Yes,0,455,34,421,428,44,384
12,Middle,Female,Black,Yes,1,35,0,35,44,3,41
12,Middle,Female,Hispanic,No,0,410,31,379,404,19,385
12,Middle,Female,Hispanic,No,1,237,24,213,199,14,185
12,Middle,Female,Hispanic,Yes,0,55,4,51,72,10,62
12,Middle,Female,Hispanic,Yes,1,50,2,48,64,6,58
12,Middle,Female,Other,No,0,335,17,318,284,22,262
12,Middle,Female,Other,No,1,518,9,509,488,17,471
12,Middle,Female,Other,Yes,0,75,9,66,48,5,43
12,Middle,Female,Other,Yes,1,10,1,9,4,0,4
12,Middle,Female,White,No,0,1480,96,1384,1242,74,1168
12,Middle,Female,White,No,1,147,15,132,136,4,132
12,Middle,Female,White,Yes,0,290,22,268,272,17,255
12,Middle,Female,White,Yes,1,5,1,4,8,0,8
12,Middle,Male,Black,No,0,2244,105,2139,2328,118,2210
12,Middle,Male,Black,No,1,358,10,348,465,13,452
12,Middle,Male,Black,Yes,0,1099,72,1027,1013,73,940
12,Middle,Male,Black,Yes,1,70,4,66,52,1,51
12,Middle,Male,Hispanic,No,0,300,31,269,385,33,352
12,Middle,Male,Hispanic,No,1,213,14,199,150,12,138
12,Middle,Male,Hispanic,Yes,0,200,18,182,164,15,149
12,Middle,Male,Hispanic,Yes,1,57,4,53,116,20,96
12,Middle,Male,Other,No,0,318,40,278,316,25,291
12,Middle,Male,Other,No,1,565,21,544,480,10,470
12,Middle,Male,Other,Yes,0,100,6,94,76,10,66
12,Middle,Male,Other,Yes,1,55,8,47,60,3,57
12,Middle,Male,White,No,0,1478,106,1372,1160,72,1088
12,Middle,Male,White,No,1,165,9,156,188,7,181
12,Middle,Male,White,Yes,0,618,56,562,644,73,571
12,Middle,Male,White,Yes,1,15,0,15,4,0,4
12,Other,Female,Black,No,0,2421,316,2105,2242,254,1988
12,Other,Female,Black,No,1,195,12,183,120,13,107
12,Other,Female,Black,Yes,0,320,62,258,328,45,283
12,Other,Female,Black,Yes,1,10,1,9,8,1,7
12,Other,Female,Hispanic,No,0,766,150,616,694,129,565
12,Other,Female,Hispanic,No,1,892,187,705,739,138,601
12,Other,Female,Hispanic,Yes,0,91,17,74,80,14,66
12,Other,Female,Hispanic,Yes,1,222,39,183,164,36,128
12,Other,Female,Other,No,0,333,56,277,335,36,299
12,Other,Female,Other,No,1,245,9,236,168,4,164
12,Other,Female,Other,Yes,0,50,10,40,40,6,34
12,Other,Female,Other,Yes,1,10,0,10,8,0,8
12,Other,Female,White,No,0,700,103,597,683,69,614
12,Other,Female,White,No,1,55,7,48,48,3,45
12,Other,Female,White,Yes,0,154,18,136,189,29,160
12,Other,Female,White,Yes,1,10,2,8,8,6,2
12,Other,Male,Black,No,0,2397,320,2077,2213,237,1976
12,Other,Male,Black,No,1,150,6,144,155,7,148
12,Other,Male,Black,Yes,0,874,133,741,754,106,648
12,Other,Male,Black,Yes,1,25,9,16,32,3,29
12,Other,Male,Hispanic,No,0,665,130,535,581,98,483
12,Other,Male,Hispanic,No,1,915,174,741,737,132,605
12,Other,Male,Hispanic,Yes,0,254,55,199,240,51,189
12,Other,Male,Hispanic,Yes,1,553,113,440,409,93,316
12,Other,Male,Other,No,0,249,36,213,320,37,283
12,Other,Male,Other,No,1,240,5,235,140,1,139
12,Other,Male,Other,Yes,0,130,24,106,119,16,103
12,Other,Male,Other,Yes,1,5,0,5,4,0,4
12,Other,Male,White,No,0,840,105,735,777,74,703
12,Other,Male,White,No,1,26,0,26,44,10,34
12,Other,Male,White,Yes,0,451,81,370,405,73,332
12,Other,Male,White,Yes,1,20,3,17,28,3,25
13,Elementary,Female,Black,No,0,8169,692,7477,4718,382,4336
13,Elementary,Female,Black,No,1,1099,36,1063,776,31,745
13,Elementary,Female,Black,Yes,0,1535,153,1382,831,73,758
13,Elementary,Female,Black,Yes,1,50,3,47,21,1,20
13,Elementary,Female,Hispanic,No,0,1309,101,1208,771,90,681
13,Elementary,Female,Hispanic,No,1,376,38,338,192,19,173
13,Elementary,Female,Hispanic,Yes,0,250,37,213,168,19,149
13,Elementary,Female,Hispanic,Yes,1,135,17,118,81,10,71
13,Elementary,Female,Other,No,0,1941,208,1733,1306,114,1192
13,Elementary,Female,Other,No,1,1405,60,1345,855,37,818
13,Elementary,Female,Other,Yes,0,325,43,282,216,26,190
13,Elementary,Female,Other,Yes,1,45,1,44,39,1,38
13,Elementary,Female,White,No,0,4097,321,3776,2332,182,2150
13,Elementary,Female,White,No,1,420,34,386,273,17,256
13,Elementary,Female,White,Yes,0,1128,84,1044,609,64,545
13,Elementary,Female,White,Yes,1,25,0,25,12,1,11
13,Elementary,Male,Black,No,0,7507,542,6965,4359,325,4034
13,Elementary,Male,Black,No,1,1110,56,1054,731,40,691
13,Elementary,Male,Black,Yes,0,3180,341,2839,1925,175,1750
13,Elementary,Male,Black,Yes,1,155,5,150,81,8,73
13,Elementary,Male,Hispanic,No,0,1236,105,1131,754,82,672
13,Elementary,Male,Hispanic,No,1,395,33,362,243,28,215
13,Elementary,Male,Hispanic,Yes,0,446,67,379,300,40,260
13,Elementary,Male,Hispanic,Yes,1,180,26,154,93,15,78
13,Elementary,Male,Other,No,0,1750,165,1585,1164,106,1058
13,Elementary,Male,Other,No,1,1610,89,1521,1025,47,978
13,Elementary,Male,Other,Yes,0,625,72,553,432,39,393
13,Elementary,Male,Other,Yes,1,105,11,94,57,4,53
13,Elementary,Male,White,No,0,3435,285,3150,1929,173,1756
13,Elementary,Male,White,No,1,480,34,446,331,30,301
13,Elementary,Male,White,Yes,0,1997,182,1815,1104,109,995
13,Elementary,Male,White,Yes,1,50,4,46,33,4,29
13,High,Female,Black,No,0,3957,328,3629,2409,249,2160
13,High,Female,Black,No,1,595,27,568,472,15,457
13,High,Female,Black,Yes,0,853,92,761,503,72,431
13,High,Female,Black,Yes,1,70,2,68,42,4,38
13,High,Female,Hispanic,No,0,664,72,592,402,44,358
13,High,Female,Hispanic,No,1,390,67,323,274,38,236
13,High,Female,Hispanic,Yes,0,95,12,83,54,7,47
13,High,Female,Hispanic,Yes,1,95,7,88,54,5,49
13,High,Female,Other,No,0,405,53,352,242,27,215
13,High,Female,Other,No,1,960,56,904,595,36,559
13,High,Female,Other,Yes,0,60,2,58,33,3,30
13,High,Female,Other,Yes,1,25,2,23,20,1,19
13,High,Female,White,No,0,1895,169,1726,1118,102,1016
13,High,Female,White,No,1,205,9,196,132,8,124
13,High,Female,White,Yes,0,532,42,490,247,32,215
13,High,Male,Black,No,0,3546,275,3271,1921,135,1786
13,High,Male,Black,No,1,624,26,598,441,19,422
13,High,Male,Black,Yes,0,1426,137,1289,833,103,730
13,High,Male,Black,Yes,1,60,2,58,45,0,45
13,High,Male,Hispanic,No,0,440,46,394,235,25,210
13,High,Male,Hispanic,No,1,497,61,436,271,34,237
13,High,Male,Hispanic,Yes,0,130,14,116,84,16,68
13,High,Male,Hispanic,Yes,1,195,26,169,126,24,102
13,High,Male,Other,No,0,285,23,262,195,15,180
13,High,Male,Other,No,1,1012,71,941,568,30,538
13,High,Male,Other,Yes,0,160,19,141,87,12,75
13,High,Male,Other,Yes,1,35,0,35,21,0,21
13,High,Male,White,No,0,1503,99,1404,915,75,840
13,High,Male,White,No,1,259,17,242,162,18,144
13,High,Male,White,Yes,0,622,77,545,321,48,273
13,High,Male,White,Yes,1,10,0,10,3,0,3
13,Middle,Female,Black,No,0,2549,61,2488,1927,67,1860
13,Middle,Female,Black,No,1,380,10,370,330,1,329
13,Middle,Female,Black,Yes,0,463,18,445,321,21,300
13,Middle,Female,Black,Yes,1,35,1,34,33,0,33
13,Middle,Female,Hispanic,No,0,410,16,394,303,16,287
13,Middle,Female,Hispanic,No,1,236,13,223,150,6,144
13,Middle,Female,Hispanic,Yes,0,55,5,50,54,4,50
13,Middle,Female,Hispanic,Yes,1,50,2,48,48,3,45
13,Middle,Female,Other,No,0,336,8,328,213,7,206
13,Middle,Female,Other,No,1,520,10,510,366,7,359
13,Middle,Female,Other,Yes,0,73,4,69,36,3,33
13,Middle,Female,Other,Yes,1,10,0,10,3,0,3
13,Middle,Female,White,No,0,1477,77,1400,932,50,882
13,Middle,Female,White,No,1,145,2,143,102,0,102
13,Middle,Female,White,Yes,0,290,13,277,200,6,194
13,Middle,Female,White,Yes,1,5,0,5,6,1,5
13,Middle,Male,Black,No,0,2247,47,2200,1748,44,1704
13,Middle,Male,Black,No,1,360,4,356,351,7,344
13,Middle,Male,Black,Yes,0,1100,36,1064,759,48,711
13,Middle,Male,Black,Yes,1,70,3,67,39,0,39
13,Middle,Male,Hispanic,No,0,304,12,292,290,19,271
13,Middle,Male,Hispanic,No,1,209,2,207,114,5,109
13,Middle,Male,Hispanic,Yes,0,200,8,192,123,3,120
13,Middle,Male,Hispanic,Yes,1,60,4,56,87,8,79
13,Middle,Male,Other,No,0,319,18,301,240,7,233
13,Middle,Male,Other,No,1,565,14,551,357,8,349
13,Middle,Male,Other,Yes,0,100,2,98,57,9,48
13,Middle,Male,Other,Yes,1,55,2,53,45,1,44
13,Middle,Male,White,No,0,1473,73,1400,871,57,814
13,Middle,Male,White,No,1,165,4,161,141,3,138
13,Middle,Male,White,Yes,0,620,44,576,482,43,439
13,Middle,Male,White,Yes,1,15,1,14,3,0,3
13,Other,Female,Black,No,0,2426,194,2232,1685,188,1497
13,Other,Female,Black,No,1,187,8,179,90,7,83
13,Other,Female,Black,Yes,0,317,43,274,248,40,208
13,Other,Female,Black,Yes,1,10,0,10,6,0,6
13,Other,Female,Hispanic,No,0,761,99,662,527,73,454
13,Other,Female,Hispanic,No,1,895,119,776,556,83,473
13,Other,Female,Hispanic,Yes,0,95,14,81,60,2,58
13,Other,Female,Hispanic,Yes,1,225,22,203,123,24,99
13,Other,Female,Other,No,0,336,28,308,252,26,226
13,Other,Female,Other,No,1,230,3,227,126,5,121
13,Other,Female,Other,Yes,0,50,3,47,30,3,27
13,Other,Female,Other,Yes,1,10,0,10,6,0,6
13,Other,Female,White,No,0,702,70,632,512,74,438
13,Other,Female,White,No,1,55,5,50,36,0,36
13,Other,Female,White,Yes,0,155,12,143,141,28,113
13,Other,Female,White,Yes,1,10,1,9,6,2,4
13,Other,Male,Black,No,0,2377,230,2147,1665,157,1508
13,Other,Male,Black,No,1,149,8,141,117,12,105
13,Other,Male,Black,Yes,0,881,94,787,564,59,505
13,Other,Male,Black,Yes,1,29,11,18,25,1,24
13,Other,Male,Hispanic,No,0,673,74,599,434,54,380
13,Other,Male,Hispanic,No,1,927,105,822,552,73,479
13,Other,Male,Hispanic,Yes,0,261,41,220,180,32,148
13,Other,Male,Hispanic,Yes,1,552,65,487,306,49,257
13,Other,Male,Other,No,0,253,27,226,239,17,222
13,Other,Male,Other,No,1,225,8,217,105,1,104
13,Other,Male,Other,Yes,0,130,11,119,87,19,68
13,Other,Male,Other,Yes,1,4,0,4,3,1,2
13,Other,Male,White,No,0,843,85,758,584,66,518
13,Other,Male,White,No,1,30,0,30,31,7,24
13,Other,Male,White,Yes,0,454,57,397,306,44,262
13,Other,Male,White,Yes,1,20,5,15,21,5,16
14,Elementary,Female,Black,No,0,3269,260,3009,7850,643,7207
14,Elementary,Female,Black,No,1,447,24,423,1313,61,1252
14,Elementary,Female,Black,Yes,0,617,62,555,1394,112,1282
14,Elementary,Female,Black,Yes,1,20,2,18,35,0,35
14,Elementary,Female,Hispanic,No,0,522,40,482,1294,116,1178
14,Elementary,Female,Hispanic,No,1,148,13,135,320,28,292
14,Elementary,Female,Hispanic,Yes,0,100,16,84,281,38,243
14,Elementary,Female,Hispanic,Yes,1,54,8,46,135,12,123
14,Elementary,Female,Other,No,0,775,65,710,2177,197,1980
14,Elementary,Female,Other,No,1,560,23,537,1421,37,1384
14,Elementary,Female,Other,Yes,0,130,15,115,360,38,322
14,Elementary,Female,Other,Yes,1,18,1,17,65,4,61
14,Elementary,Female,White,No,0,1638,141,1497,3858,297,3561
14,Elementary,Female,White,No,1,168,13,155,455,19,436
14,Elementary,Female,White,Yes,0,450,35,415,1015,85,930
14,Elementary,Female,White,Yes,1,10,0,10,20,0,20
14,Elementary,Male,Black,No,0,2999,217,2782,7265,573,6692
14,Elementary,Male,Black,No,1,449,18,431,1227,65,1162
14,Elementary,Male,Black,Yes,0,1269,135,1134,3207,300,2907
14,Elementary,Male,Black,Yes,1,62,6,56,135,13,122
14,Elementary,Male,Hispanic,No,0,499,37,462,1258,116,1142
14,Elementary,Male,Hispanic,No,1,158,20,138,405,40,365
14,Elementary,Male,Hispanic,Yes,0,178,17,161,500,80,420
14,Elementary,Male,Hispanic,Yes,1,72,10,62,155,20,135
14,Elementary,Male,Other,No,0,699,64,635,1936,167,1769
14,Elementary,Male,Other,No,1,644,25,619,1708,57,1651
14,Elementary,Male,Other,Yes,0,250,21,229,720,53,667
14,Elementary,Male,Other,Yes,1,42,0,42,95,9,86
14,Elementary,Male,White,No,0,1372,102,1270,3204,270,2934
14,Elementary,Male,White,No,1,192,22,170,555,38,517
14,Elementary,Male,White,Yes,0,798,58,740,1841,174,1667
14,Elementary,Male,White,Yes,1,20,3,17,55,4,51
14,High,Female,Black,No,0,1577,147,1430,3999,378,3621
14,High,Female,Black,No,1,238,14,224,797,29,768
14,High,Female,Black,Yes,0,339,37,302,832,121,711
14,High,Female,Black,Yes,1,28,1,27,70,4,66
14,High,Female,Hispanic,No,0,264,23,241,662,73,589
14,High,Female,Hispanic,No,1,156,24,132,460,71,389
14,High,Female,Hispanic,Yes,0,38,6,32,90,13,77
14,High,Female,Hispanic,Yes,1,38,4,34,90,8,82
14,High,Female,Other,No,0,162,16,146,405,33,372
14,High,Female,Other,No,1,384,24,360,986,57,929
14,High,Female,Other,Yes,0,24,2,22,55,6,49
14,High,Female,Other,Yes,1,10,3,7,32,4,28
14,High,Female,White,No,0,759,80,679,1854,166,1688
14,High,Female,White,No,1,82,3,79,222,13,209
14,High,Female,White,Yes,0,211,30,181,408,53,355
14,High,Male,Black,No,0,1418,112,1306,3182,254,2928
14,High,Male,Black,No,1,250,12,238,735,20,715
14,High,Male,Black,Yes,0,570,61,509,1385,174,1211
14,High,Male,Black,Yes,1,24,0,24,75,1,74
14,High,Male,Hispanic,No,0,176,16,160,395,40,355
14,High,Male,Hispanic,No,1,196,22,174,448,42,406
14,High,Male,Hispanic,Yes,0,54,7,47,140,20,120
14,High,Male,Hispanic,Yes,1,78,11,67,210,38,172
14,High,Male,Other,No,0,113,1,112,325,20,305
14,High,Male,Other,No,1,400,35,365,938,50,888
14,High,Male,Other,Yes,0,62,9,53,136,15,121
14,High,Male,Other,Yes,1,14,0,14,35,2,33
14,High,Male,White,No,0,602,43,559,1520,106,1414
14,High,Male,White,No,1,102,8,94,270,25,245
14,High,Male,White,Yes,0,248,27,221,535,70,465
14,High,Male,White,Yes,1,4,0,4,5,0,5
14,Middle,Female,Black,No,0,1021,23,998,3200,65,3135
14,Middle,Female,Black,No,1,152,2,150,550,2,548
14,Middle,Female,Black,Yes,0,188,5,183,535,16,519
14,Middle,Female,Black,Yes,1,14,0,14,55,1,54
14,Middle,Female,Hispanic,No,0,164,5,159,505,16,489
14,Middle,Female,Hispanic,No,1,94,5,89,250,8,242
14,Middle,Female,Hispanic,Yes,0,22,2,20,90,12,78
14,Middle,Female,Hispanic,Yes,1,20,1,19,80,0,80
14,Middle,Female,Other,No,0,134,5,129,355,12,343
14,Middle,Female,Other,No,1,206,6,200,610,12,598
14,Middle,Female,Other,Yes,0,28,1,27,60,6,54
14,Middle,Female,Other,Yes,1,4,1,3,5,0,5
14,Middle,Female,White,No,0,587,19,568,1549,57,1492
14,Middle,Female,White,No,1,58,2,56,170,4,166
14,Middle,Female,White,Yes,0,114,5,109,333,13,320
14,Middle,Female,White,Yes,1,2,0,2,10,0,10
14,Middle,Male,Black,No,0,898,16,882,2908,69,2839
14,Middle,Male,Black,No,1,144,5,139,588,15,573
14,Middle,Male,Black,Yes,0,446,8,438,1265,74,1191
14,Middle,Male,Black,Yes,1,28,1,27,65,1,64
14,Middle,Male,Hispanic,No,0,122,3,119,479,13,466
14,Middle,Male,Hispanic,No,1,84,2,82,190,7,183
14,Middle,Male,Hispanic,Yes,0,79,3,76,205,6,199
14,Middle,Male,Hispanic,Yes,1,24,1,23,145,16,129
14,Middle,Male,Other,No,0,128,6,122,400,16,384
14,Middle,Male,Other,No,1,226,12,214,598,14,584
14,Middle,Male,Other,Yes,0,40,0,40,94,7,87
14,Middle,Male,Other,Yes,1,22,1,21,75,2,73
14,Middle,Male,White,No,0,588,35,553,1455,87,1368
14,Middle,Male,White,No,1,66,0,66,235,8,227
14,Middle,Male,White,Yes,0,250,14,236,795,65,730
14,Middle,Male,White,Yes,1,6,0,6,5,0,5
14,Other,Female,Black,No,0,971,83,888,2815,314,2501
14,Other,Female,Black,No,1,79,3,76,150,13,137
14,Other,Female,Black,Yes,0,124,24,100,424,46,378
14,Other,Female,Black,Yes,1,4,0,4,10,0,10
14,Other,Female,Hispanic,No,0,305,22,283,883,108,775
14,Other,Female,Hispanic,No,1,356,51,305,932,93,839
14,Other,Female,Hispanic,Yes,0,37,4,33,100,14,86
14,Other,Female,Hispanic,Yes,1,90,5,85,205,24,181
14,Other,Female,Other,No,0,136,10,126,423,34,389
14,Other,Female,Other,No,1,98,3,95,210,6,204
14,Other,Female,Other,Yes,0,20,2,18,50,7,43
14,Other,Female,Other,Yes,1,4,0,4,10,0,10
14,Other,Female,White,No,0,280,32,248,854,124,730
14,Other,Female,White,No,1,22,2,20,60,6,54
14,Other,Female,White,Yes,0,61,3,58,235,53,182
14,Other,Female,White,Yes,1,4,2,2,10,0,10
14,Other,Male,Black,No,0,954,87,867,2805,253,2552
14,Other,Male,Black,No,1,61,6,55,196,23,173
14,Other,Male,Black,Yes,0,346,33,313,947,132,815
14,Other,Male,Black,Yes,1,12,4,8,45,3,42
14,Other,Male,Hispanic,No,0,272,20,252,720,83,637
14,Other,Male,Hispanic,No,1,373,17,356,920,97,823
14,Other,Male,Hispanic,Yes,0,106,11,95,300,60,240
14,Other,Male,Hispanic,Yes,1,222,32,190,510,61,449
14,Other,Male,Other,No,0,100,11,89,398,31,367
14,Other,Male,Other,No,1,96,4,92,179,4,175
14,Other,Male,Other,Yes,0,52,4,48,148,14,134
14,Other,Male,Other,Yes,1,2,0,2,5,0,5
14,Other,Male,White,No,0,337,32,305,973,114,859
14,Other,Male,White,No,1,12,0,12,50,10,40
14,Other,Male,White,Yes,0,182,19,163,513,68,445
14,Other,Male,White,Yes,1,8,2,6,35,9,26
15,Elementary,Female,Black,No,0,8176,589,7587,7822,570,7252
15,Elementary,Female,Black,No,1,1120,61,1059,1336,80,1256
15,Elementary,Female,Black,Yes,0,1542,162,1380,1395,116,1279
15,Elementary,Female,Black,Yes,1,50,1,49,35,3,32
15,Elementary,Female,Hispanic,No,0,1312,108,1204,1288,127,1161
15,Elementary,Female,Hispanic,No,1,366,31,335,320,40,280
15,Elementary,Female,Hispanic,Yes,0,250,38,212,285,35,250
15,Elementary,Female,Hispanic,Yes,1,131,18,113,135,20,115
15,Elementary,Female,Other,No,0,1937,177,1760,2178,186,1992
15,Elementary,Female,Other,No,1,1405,66,1339,1420,58,1362
15,Elementary,Female,Other,Yes,0,325,39,286,360,31,329
15,Elementary,Female,Other,Yes,1,45,6,39,67,3,64
15,Elementary,Female,White,No,0,4094,354,3740,3862,293,3569
15,Elementary,Female,White,No,1,417,28,389,460,30,430
15,Elementary,Female,White,Yes,0,1125,110,1015,1011,89,922
15,Elementary,Female,White,Yes,1,25,0,25,20,1,19
15,Elementary,Male,Black,No,0,7501,547,6954,7260,570,6690
15,Elementary,Male,Black,No,1,1125,62,1063,1247,65,1182
15,Elementary,Male,Black,Yes,0,3163,303,2860,3217,283,2934
15,Elementary,Male,Black,Yes,1,155,20,135,135,10,125
15,Elementary,Male,Hispanic,No,0,1255,98,1157,1258,121,1137
15,Elementary,Male,Hispanic,No,1,391,44,347,408,32,376
15,Elementary,Male,Hispanic,Yes,0,445,52,393,500,59,441
15,Elementary,Male,Hispanic,Yes,1,180,37,143,155,26,129
15,Elementary,Male,Other,No,0,1743,145,1598,1941,188,1753
15,Elementary,Male,Other,No,1,1609,64,1545,1711,72,1639
15,Elementary,Male,Other,Yes,0,626,69,557,720,58,662
15,Elementary,Male,Other,Yes,1,105,4,101,95,4,91
15,Elementary,Male,White,No,0,3431,282,3149,3190,248,2942
15,Elementary,Male,White,No,1,480,37,443,560,33,527
15,Elementary,Male,White,Yes,0,1995,191,1804,1845,167,1678
15,Elementary,Male,White,Yes,1,50,5,45,55,5,50
15,High,Female,Black,No,0,3940,340,3600,3992,350,3642
15,High,Female,Black,No,1,598,36,562,812,29,783
15,High,Female,Black,Yes,0,849,67,782,828,121,707
15,High,Female,Black,Yes,1,70,3,67,70,1,69
15,High,Female,Hispanic,No,0,657,73,584,655,76,579
15,High,Female,Hispanic,No,1,391,60,331,463,78,385
15,High,Female,Hispanic,Yes,0,93,8,85,90,13,77
15,High,Female,Hispanic,Yes,1,97,7,90,90,16,74
15,High,Female,Other,No,0,405,46,359,401,27,374
15,High,Female,Other,No,1,960,60,900,987,76,911
15,High,Female,Other,Yes,0,60,6,54,55,5,50
15,High,Female,Other,Yes,1,25,1,24,33,1,32
15,High,Female,White,No,0,1888,189,1699,1855,156,1699
15,High,Female,White,No,1,205,10,195,227,9,218
15,High,Female,White,Yes,0,522,72,450,406,57,349
15,High,Male,Black,No,0,3537,266,3271,3178,239,2939
15,High,Male,Black,No,1,625,30,595,744,25,719
15,High,Male,Black,Yes,0,1416,125,1291,1373,166,1207
15,High,Male,Black,Yes,1,60,0,60,75,1,74
15,High,Male,Hispanic,No,0,440,49,391,397,32,365
15,High,Male,Hispanic,No,1,490,61,429,447,55,392
15,High,Male,Hispanic,Yes,0,135,18,117,140,22,118
15,High,Male,Hispanic,Yes,1,195,23,172,210,32,178
15,High,Male,Other,No,0,275,18,257,325,20,305
15,High,Male,Other,No,1,993,79,914,935,55,880
15,High,Male,Other,Yes,0,151,13,138,135,13,122
15,High,Male,Other,Yes,1,35,1,34,35,1,34
15,High,Male,White,No,0,1507,119,1388,1509,128,1381
15,High,Male,White,No,1,260,21,239,270,33,237
15,High,Male,White,Yes,0,621,77,544,535,68,467
15,High,Male,White,Yes,1,10,1,9,5,0,5
15,Middle,Female,Black,No,0,2562,68,2494,3206,100,3106
15,Middle,Female,Black,No,1,380,16,364,558,5,553
15,Middle,Female,Black,Yes,0,469,15,454,539,26,513
15,Middle,Female,Black,Yes,1,35,5,30,55,5,50
15,Middle,Female,Hispanic,No,0,410,18,392,508,20,488
15,Middle,Female,Hispanic,No,1,235,9,226,250,5,245
15,Middle,Female,Hispanic,Yes,0,55,2,53,90,11,79
15,Middle,Female,Hispanic,Yes,1,50,5,45,80,1,79
15,Middle,Female,Other,No,0,330,14,316,352,8,344
15,Middle,Female,Other,No,1,515,7,508,612,10,602
15,Middle,Female,Other,Yes,0,70,6,64,60,9,51
15,Middle,Female,Other,Yes,1,10,0,10,5,0,5
15,Middle,Female,White,No,0,1467,52,1415,1550,54,1496
15,Middle,Female,White,No,1,145,4,141,170,4,166
15,Middle,Female,White,Yes,0,288,15,273,335,7,328
15,Middle,Female,White,Yes,1,5,0,5,10,0,10
15,Middle,Male,Black,No,0,2240,47,2193,2908,103,2805
15,Middle,Male,Black,No,1,360,6,354,592,10,582
15,Middle,Male,Black,Yes,0,1110,21,1089,1266,59,1207
15,Middle,Male,Black,Yes,1,70,4,66,65,7,58
15,Middle,Male,Hispanic,No,0,307,11,296,480,21,459
15,Middle,Male,Hispanic,No,1,209,12,197,190,11,179
15,Middle,Male,Hispanic,Yes,0,200,3,197,205,9,196
15,Middle,Male,Hispanic,Yes,1,60,2,58,145,10,135
15,Middle,Male,Other,No,0,322,15,307,395,24,371
15,Middle,Male,Other,No,1,565,18,547,600,15,585
15,Middle,Male,Other,Yes,0,100,2,98,90,11,79
15,Middle,Male,Other,Yes,1,55,3,52,75,2,73
15,Middle,Male,White,No,0,1475,76,1399,1454,66,1388
15,Middle,Male,White,No,1,165,3,162,236,3,233
15,Middle,Male,White,Yes,0,625,37,588,790,69,721
15,Middle,Male,White,Yes,1,15,0,15,5,0,5
15,Other,Female,Black,No,0,2416,219,2197,2829,303,2526
15,Other,Female,Black,No,1,206,7,199,160,17,143
15,Other,Female,Black,Yes,0,308,44,264,432,57,375
15,Other,Female,Black,Yes,1,10,1,9,10,0,10
15,Other,Female,Hispanic,No,0,748,83,665,890,105,785
15,Other,Female,Hispanic,No,1,880,120,760,936,104,832
15,Other,Female,Hispanic,Yes,0,90,9,81,102,11,91
15,Other,Female,Hispanic,Yes,1,226,14,212,205,15,190
15,Other,Female,Other,No,0,339,21,318,425,37,388
15,Other,Female,Other,No,1,245,3,242,210,3,207
15,Other,Female,Other,Yes,0,48,4,44,50,8,42
15,Other,Female,Other,Yes,1,10,1,9,10,0,10
15,Other,Female,White,No,0,668,60,608,856,120,736
15,Other,Female,White,No,1,55,3,52,63,1,62
15,Other,Female,White,Yes,0,155,13,142,235,42,193
15,Other,Female,White,Yes,1,10,1,9,10,1,9
15,Other,Male,Black,No,0,2359,215,2144,2814,244,2570
15,Other,Male,Black,No,1,153,8,145,198,16,182
15,Other,Male,Black,Yes,0,881,88,793,952,113,839
15,Other,Male,Black,Yes,1,30,10,20,45,3,42
15,Other,Male,Hispanic,No,0,667,62,605,717,90,627
15,Other,Male,Hispanic,No,1,927,101,826,920,113,807
15,Other,Male,Hispanic,Yes,0,263,35,228,300,52,248
15,Other,Male,Hispanic,Yes,1,553,42,511,510,55,455
15,Other,Male,Other,No,0,248,24,224,395,28,367
15,Other,Male,Other,No,1,239,9,230,185,5,180
15,Other,Male,Other,Yes,0,135,15,120,150,17,133
15,Other,Male,Other,Yes,1,5,0,5,5,1,4
15,Other,Male,White,No,0,824,85,739,967,98,869
15,Other,Male,White,No,1,30,0,30,50,7,43
15,Other,Male,White,Yes,0,455,53,402,515,91,424
15,Other,Male,White,Yes,1,20,2,18,35,5,30
16,Elementary,Female,Black,No,0,6543,1290,5253,7814,1118,6696
16,Elementary,Female,Black,No,1,896,97,799,1351,85,1266
16,Elementary,Female,Black,Yes,0,1225,275,950,1392,216,1176
16,Elementary,Female,Black,Yes,1,40,9,31,35,1,34
16,Elementary,Female,Hispanic,No,0,1045,231,814,1285,230,1055
16,Elementary,Female,Hispanic,No,1,292,68,224,320,82,238
16,Elementary,Female,Hispanic,Yes,0,200,55,145,285,61,224
16,Elementary,Female,Hispanic,Yes,1,102,24,78,135,35,100
16,Elementary,Female,Other,No,0,1542,320,1222,2175,294,1881
16,Elementary,Female,Other,No,1,1132,140,992,1420,116,1304
16,Elementary,Female,Other,Yes,0,260,66,194,360,46,314
16,Elementary,Female,Other,Yes,1,36,5,31,70,2,68
16,Elementary,Female,White,No,0,3270,587,2683,3867,450,3417
16,Elementary,Female,White,No,1,332,72,260,461,62,399
16,Elementary,Female,White,Yes,0,900,188,712,1010,124,886
16,Elementary,Female,White,Yes,1,20,0,20,20,0,20
16,Elementary,Male,Black,No,0,6015,1170,4845,7265,1073,6192
16,Elementary,Male,Black,No,1,902,95,807,1251,81,1170
16,Elementary,Male,Black,Yes,0,2531,541,1990,3222,491,2731
16,Elementary,Male,Black,Yes,1,124,29,95,135,23,112
16,Elementary,Male,Hispanic,No,0,1005,221,784,1260,228,1032
16,Elementary,Male,Hispanic,No,1,312,79,233,415,90,325
16,Elementary,Male,Hispanic,Yes,0,356,90,266,503,123,380
16,Elementary,Male,Hispanic,Yes,1,144,43,101,152,53,99
16,Elementary,Male,Other,No,0,1392,294,1098,1945,314,1631
16,Elementary,Male,Other,No,1,1288,145,1143,1715,126,1589
16,Elementary,Male,Other,Yes,0,504,113,391,722,100,622
16,Elementary,Male,Other,Yes,1,84,8,76,95,16,79
16,Elementary,Male,White,No,0,2743,513,2230,3187,465,2722
16,Elementary,Male,White,No,1,384,83,301,559,94,465
16,Elementary,Male,White,Yes,0,1594,319,1275,1850,249,1601
16,Elementary,Male,White,Yes,1,40,9,31,55,10,45
16,High,Female,Black,No,0,3137,430,2707,3988,590,3398
16,High,Female,Black,No,1,478,43,435,823,40,783
16,High,Female,Black,Yes,0,676,98,578,825,160,665
16,High,Female,Black,Yes,1,56,2,54,70,4,66
16,High,Female,Hispanic,No,0,528,89,439,655,112,543
16,High,Female,Hispanic,No,1,314,82,232,462,135,327
16,High,Female,Hispanic,Yes,0,72,11,61,90,13,77
16,High,Female,Hispanic,Yes,1,80,16,64,90,20,70
16,High,Female,Other,No,0,324,61,263,395,63,332
16,High,Female,Other,No,1,764,68,696,988,101,887
16,High,Female,Other,Yes,0,48,3,45,55,11,44
16,High,Female,Other,Yes,1,20,2,18,32,3,29
16,High,Female,White,No,0,1501,224,1277,1855,256,1599
16,High,Female,White,No,1,164,15,149,225,21,204
16,High,Female,White,Yes,0,420,63,357,415,73,342
16,High,Male,Black,No,0,2815,365,2450,3178,413,2765
16,High,Male,Black,No,1,499,34,465,755,27,728
16,High,Male,Black,Yes,0,1131,154,977,1367,221,1146
16,High,Male,Black,Yes,1,48,1,47,80,7,73
16,High,Male,Hispanic,No,0,350,67,283,400,71,329
16,High,Male,Hispanic,No,1,380,75,305,448,75,373
16,High,Male,Hispanic,Yes,0,108,19,89,143,32,111
16,High,Male,Hispanic,Yes,1,156,26,130,210,50,160
16,High,Male,Other,No,0,220,22,198,325,19,306
16,High,Male,Other,No,1,790,63,727,935,97,838
16,High,Male,Other,Yes,0,120,17,103,130,22,108
16,High,Male,Other,Yes,1,28,1,27,35,2,33
16,High,Male,White,No,0,1206,146,1060,1504,196,1308
16,High,Male,White,No,1,207,28,179,273,49,224
16,High,Male,White,Yes,0,493,87,406,534,106,428
16,High,Male,White,Yes,1,8,2,6,5,0,5
16,Middle,Female,Black,No,0,2053,103,1950,3214,122,3092
16,Middle,Female,Black,No,1,304,13,291,563,8,555
16,Middle,Female,Black,Yes,0,379,22,357,540,31,509
16,Middle,Female,Black,Yes,1,28,1,27,55,2,53
16,Middle,Female,Hispanic,No,0,328,35,293,510,27,483
16,Middle,Female,Hispanic,No,1,188,10,178,253,19,234
16,Middle,Female,Hispanic,Yes,0,40,5,35,90,12,78
16,Middle,Female,Hispanic,Yes,1,40,2,38,80,4,76
16,Middle,Female,Other,No,0,264,20,244,354,23,331
16,Middle,Female,Other,No,1,412,20,392,618,20,598
16,Middle,Female,Other,Yes,0,56,8,48,62,15,47
16,Middle,Female,Other,Yes,1,8,0,8,5,0,5
16,Middle,Female,White,No,0,1178,72,1106,1550,66,1484
16,Middle,Female,White,No,1,116,7,109,170,5,165
16,Middle,Female,White,Yes,0,232,23,209,335,21,314
16,Middle,Female,White,Yes,1,4,0,4,10,0,10
16,Middle,Male,Black,No,0,1797,102,1695,2905,134,2771
16,Middle,Male,Black,No,1,287,15,272,595,10,585
16,Middle,Male,Black,Yes,0,891,63,828,1266,84,1182
16,Middle,Male,Black,Yes,1,56,3,53,65,2,63
16,Middle,Male,Hispanic,No,0,250,29,221,480,41,439
16,Middle,Male,Hispanic,No,1,160,14,146,190,18,172
16,Middle,Male,Hispanic,Yes,0,160,11,149,204,15,189
16,Middle,Male,Hispanic,Yes,1,48,7,41,145,13,132
16,Middle,Male,Other,No,0,260,17,243,395,33,362
16,Middle,Male,Other,No,1,452,18,434,600,28,572
16,Middle,Male,Other,Yes,0,80,11,69,90,16,74
16,Middle,Male,Other,Yes,1,44,6,38,75,6,69
16,Middle,Male,White,No,0,1181,101,1080,1455,89,1366
16,Middle,Male,White,No,1,132,8,124,240,16,224
16,Middle,Male,White,Yes,0,501,41,460,790,79,711
16,Middle,Male,White,Yes,1,12,0,12,5,0,5
16,Other,Female,Black,No,0,1957,298,1659,2840,427,2413
16,Other,Female,Black,No,1,179,9,170,160,21,139
16,Other,Female,Black,Yes,0,248,47,201,435,71,364
16,Other,Female,Black,Yes,1,8,1,7,10,3,7
16,Other,Female,Hispanic,No,0,599,130,469,893,169,724
16,Other,Female,Hispanic,No,1,708,182,526,936,179,757
16,Other,Female,Hispanic,Yes,0,72,13,59,105,7,98
16,Other,Female,Hispanic,Yes,1,182,38,144,205,38,167
16,Other,Female,Other,No,0,275,37,238,428,47,381
16,Other,Female,Other,No,1,211,9,202,210,10,200
16,Other,Female,Other,Yes,0,40,5,35,50,8,42
16,Other,Female,Other,Yes,1,8,0,8,10,0,10
16,Other,Female,White,No,0,539,81,458,850,136,714
16,Other,Female,White,No,1,44,5,39,65,12,53
16,Other,Female,White,Yes,0,124,24,100,236,51,185
16,Other,Female,White,Yes,1,8,3,5,10,3,7
16,Other,Male,Black,No,0,1906,276,1630,2820,356,2464
16,Other,Male,Black,No,1,130,8,122,201,22,179
16,Other,Male,Black,Yes,0,712,114,598,967,159,808
16,Other,Male,Black,Yes,1,24,12,12,45,3,42
16,Other,Male,Hispanic,No,0,537,114,423,715,135,580
16,Other,Male,Hispanic,No,1,759,158,601,918,190,728
16,Other,Male,Hispanic,Yes,0,208,41,167,303,77,226
16,Other,Male,Hispanic,Yes,1,444,97,347,510,111,399
16,Other,Male,Other,No,0,202,27,175,390,45,345
16,Other,Male,Other,No,1,207,6,201,185,9,176
16,Other,Male,Other,Yes,0,108,17,91,150,23,127
16,Other,Male,Other,Yes,1,5,0,5,5,0,5
16,Other,Male,White,No,0,666,93,573,971,149,822
16,Other,Male,White,No,1,24,2,22,50,8,42
16,Other,Male,White,Yes,0,370,61,309,512,88,424
16,Other,Male,White,Yes,1,16,2,14,35,9,26
17,Elementary,Female,Black,No,0,9813,983,8830,6226,677,5549
17,Elementary,Female,Black,No,1,1344,78,1266,1084,72,1012
17,Elementary,Female,Black,Yes,0,1828,216,1612,1112,112,1000
17,Elementary,Female,Black,Yes,1,60,3,57,28,2,26
17,Elementary,Female,Hispanic,No,0,1571,175,1396,1023,117,906
17,Elementary,Female,Hispanic,No,1,439,69,370,256,42,214
17,Elementary,Female,Hispanic,Yes,0,304,48,256,225,37,188
17,Elementary,Female,Hispanic,Yes,1,150,26,124,108,22,86
17,Elementary,Female,Other,No,0,2317,264,2053,1742,203,1539
17,Elementary,Female,Other,No,1,1698,94,1604,1139,41,1098
17,Elementary,Female,Other,Yes,0,387,49,338,288,34,254
17,Elementary,Female,Other,Yes,1,54,3,51,56,6,50
17,Elementary,Female,White,No,0,4883,436,4447,3084,327,2757
17,Elementary,Female,White,No,1,509,49,460,372,35,337
17,Elementary,Female,White,Yes,0,1347,121,1226,804,84,720
17,Elementary,Female,White,Yes,1,30,0,30,16,2,14
17,Elementary,Male,Black,No,0,9025,874,8151,5826,653,5173
17,Elementary,Male,Black,No,1,1356,81,1275,1004,63,941
17,Elementary,Male,Black,Yes,0,3798,412,3386,2587,313,2274
17,Elementary,Male,Black,Yes,1,186,16,170,108,18,90
17,Elementary,Male,Hispanic,No,0,1512,167,1345,1008,142,866
17,Elementary,Male,Hispanic,No,1,465,60,405,332,54,278
17,Elementary,Male,Hispanic,Yes,0,539,84,455,408,70,338
17,Elementary,Male,Hispanic,Yes,1,213,35,178,120,34,86
17,Elementary,Male,Other,No,0,2097,212,1885,1560,174,1386
17,Elementary,Male,Other,No,1,1935,86,1849,1358,96,1262
17,Elementary,Male,Other,Yes,0,750,121,629,580,53,527
17,Elementary,Male,Other,Yes,1,126,11,115,76,16,60
17,Elementary,Male,White,No,0,4123,392,3731,2541,276,2265
17,Elementary,Male,White,No,1,583,65,518,443,35,408
17,Elementary,Male,White,Yes,0,2382,258,2124,1478,149,1329
17,Elementary,Male,White,Yes,1,60,6,54,44,10,34
17,High,Female,Black,No,0,4701,383,4318,3195,425,2770
17,High,Female,Black,No,1,717,36,681,658,34,624
17,High,Female,Black,Yes,0,1019,88,931,656,111,545
17,High,Female,Black,Yes,1,84,2,82,56,3,53
17,High,Female,Hispanic,No,0,792,91,701,524,87,437
17,High,Female,Hispanic,No,1,468,83,385,367,115,252
17,High,Female,Hispanic,Yes,0,108,16,92,72,12,60
17,High,Female,Hispanic,Yes,1,120,17,103,72,11,61
17,High,Female,Other,No,0,477,67,410,316,47,269
17,High,Female,Other,No,1,1146,90,1056,785,68,717
17,High,Female,Other,Yes,0,72,11,61,44,11,33
17,High,Female,Other,Yes,1,30,2,28,26,2,24
17,High,Female,White,No,0,2250,234,2016,1482,182,1300
17,High,Female,White,No,1,243,15,228,177,13,164
17,High,Female,White,Yes,0,633,69,564,334,56,278
17,High,Male,Black,No,0,4210,368,3842,2549,285,2264
17,High,Male,Black,No,1,750,48,702,604,31,573
17,High,Male,Black,Yes,0,1699,170,1529,1096,167,929
17,High,Male,Black,Yes,1,72,2,70,64,2,62
17,High,Male,Hispanic,No,0,527,83,444,320,43,277
17,High,Male,Hispanic,No,1,565,105,460,356,69,287
17,High,Male,Hispanic,Yes,0,159,17,142,116,24,92
17,High,Male,Hispanic,Yes,1,233,39,194,164,33,131
17,High,Male,Other,No,0,325,13,312,260,27,233
17,High,Male,Other,No,1,1188,100,1088,748,50,698
17,High,Male,Other,Yes,0,180,19,161,104,13,91
17,High,Male,Other,Yes,1,42,2,40,28,0,28
17,High,Male,White,No,0,1810,162,1648,1200,121,1079
17,High,Male,White,No,1,309,29,280,216,35,181
17,High,Male,White,Yes,0,730,114,616,424,76,348
17,High,Male,White,Yes,1,12,0,12,4,0,4
17,Middle,Female,Black,No,0,3072,92,2980,2571,147,2424
17,Middle,Female,Black,No,1,456,12,444,452,9,443
17,Middle,Female,Black,Yes,0,570,22,548,432,25,407
17,Middle,Female,Black,Yes,1,42,1,41,44,2,42
17,Middle,Female,Hispanic,No,0,487,34,453,408,25,383
17,Middle,Female,Hispanic,No,1,282,16,266,204,15,189
17,Middle,Female,Hispanic,Yes,0,60,3,57,70,8,62
17,Middle,Female,Hispanic,Yes,1,60,8,52,64,6,58
17,Middle,Female,Other,No,0,393,39,354,284,22,262
17,Middle,Female,Other,No,1,618,12,606,493,11,482
17,Middle,Female,Other,Yes,0,84,11,73,48,12,36
17,Middle,Female,Other,Yes,1,12,2,10,4,0,4
17,Middle,Female,White,No,0,1769,86,1683,1240,58,1182
17,Middle,Female,White,No,1,174,8,166,136,7,129
17,Middle,Female,White,Yes,0,351,22,329,271,25,246
17,Middle,Female,White,Yes,1,6,0,6,8,0,8
17,Middle,Male,Black,No,0,2691,95,2596,2324,107,2217
17,Middle,Male,Black,No,1,432,8,424,476,9,467
17,Middle,Male,Black,Yes,0,1338,44,1294,1016,77,939
17,Middle,Male,Black,Yes,1,84,1,83,52,2,50
17,Middle,Male,Hispanic,No,0,378,33,345,384,21,363
17,Middle,Male,Hispanic,No,1,240,7,233,148,5,143
17,Middle,Male,Hispanic,Yes,0,244,14,230,164,12,152
17,Middle,Male,Hispanic,Yes,1,72,7,65,116,7,109
17,Middle,Male,Other,No,0,395,30,365,314,25,289
17,Middle,Male,Other,No,1,679,30,649,479,14,465
17,Middle,Male,Other,Yes,0,120,7,113,72,10,62
17,Middle,Male,Other,Yes,1,66,2,64,59,8,51
17,Middle,Male,White,No,0,1769,99,1670,1164,74,1090
17,Middle,Male,White,No,1,198,7,191,189,5,184
17,Middle,Male,White,Yes,0,750,42,708,631,62,569
17,Middle,Male,White,Yes,1,18,0,18,4,0,4
17,Other,Female,Black,No,0,2959,294,2665,2269,276,1993
17,Other,Female,Black,No,1,249,12,237,128,17,111
17,Other,Female,Black,Yes,0,369,55,314,348,51,297
17,Other,Female,Black,Yes,1,12,1,11,8,3,5
17,Other,Female,Hispanic,No,0,897,116,781,709,112,597
17,Other,Female,Hispanic,No,1,1070,175,895,752,127,625
17,Other,Female,Hispanic,Yes,0,108,13,95,84,7,77
17,Other,Female,Hispanic,Yes,1,276,37,239,164,31,133
17,Other,Female,Other,No,0,398,57,341,344,32,312
17,Other,Female,Other,No,1,294,7,287,168,8,160
17,Other,Female,Other,Yes,0,60,6,54,40,6,34
17,Other,Female,Other,Yes,1,12,0,12,8,0,8
17,Other,Female,White,No,0,793,77,716,680,101,579
17,Other,Female,White,No,1,66,9,57,52,4,48
17,Other,Female,White,Yes,0,184,19,165,190,44,146
17,Other,Female,White,Yes,1,12,3,9,8,3,5
17,Other,Male,Black,No,0,2869,259,2610,2256,229,2027
17,Other,Male,Black,No,1,192,12,180,164,14,150
17,Other,Male,Black,Yes,0,1070,116,954,768,101,667
17,Other,Male,Black,Yes,1,36,8,28,36,2,34
17,Other,Male,Hispanic,No,0,801,115,686,574,81,493
17,Other,Male,Hispanic,No,1,1135,170,965,736,154,582
17,Other,Male,Hispanic,Yes,0,316,67,249,244,50,194
17,Other,Male,Hispanic,Yes,1,667,85,582,408,95,313
17,Other,Male,Other,No,0,303,30,273,312,30,282
17,Other,Male,Other,No,1,288,10,278,148,3,145
17,Other,Male,Other,Yes,0,162,25,137,120,18,102
17,Other,Male,Other,Yes,1,6,0,6,4,1,3
17,Other,Male,White,No,0,1003,96,907,771,114,657
17,Other,Male,White,No,1,36,2,34,44,6,38
17,Other,Male,White,Yes,0,553,69,484,417,79,338
17,Other,Male,White,Yes,1,24,1,23,28,8,20
18,Elementary,Female,Black,No,0,6542,1379,5163,6357,596,5761
18,Elementary,Female,Black,No,1,906,105,801,1087,68,1019
18,Elementary,Female,Black,Yes,0,1220,293,927,1137,109,1028
18,Elementary,Female,Black,Yes,1,40,6,34,28,1,27
18,Elementary,Female,Hispanic,No,0,1048,242,806,1019,98,921
18,Elementary,Female,Hispanic,No,1,295,90,205,254,39,215
18,Elementary,Female,Hispanic,Yes,0,200,51,149,229,38,191
18,Elementary,Female,Hispanic,Yes,1,100,35,65,108,14,94
18,Elementary,Female,Other,No,0,1548,357,1191,1759,164,1595
18,Elementary,Female,Other,No,1,1144,141,1003,1143,42,1101
18,Elementary,Female,Other,Yes,0,256,72,184,294,34,260
18,Elementary,Female,Other,Yes,1,36,7,29,56,8,48
18,Elementary,Female,White,No,0,3250,613,2637,3098,312,2786
18,Elementary,Female,White,No,1,344,53,291,379,39,340
18,Elementary,Female,White,Yes,0,892,185,707,816,84,732
18,Elementary,Female,White,Yes,1,20,4,16,16,0,16
18,Elementary,Male,Black,No,0,6013,1235,4778,5953,527,5426
18,Elementary,Male,Black,No,1,911,111,800,1012,50,962
18,Elementary,Male,Black,Yes,0,2526,558,1968,2635,265,2370
18,Elementary,Male,Black,Yes,1,124,19,105,108,23,85
18,Elementary,Male,Hispanic,No,0,1006,265,741,1014,105,909
18,Elementary,Male,Hispanic,No,1,312,96,216,329,34,295
18,Elementary,Male,Hispanic,Yes,0,364,84,280,413,61,352
18,Elementary,Male,Hispanic,Yes,1,140,43,97,120,22,98
18,Elementary,Male,Other,No,0,1404,294,1110,1598,181,1417
18,Elementary,Male,Other,No,1,1297,148,1149,1352,55,1297
18,Elementary,Male,Other,Yes,0,500,132,368,584,50,534
18,Elementary,Male,Other,Yes,1,84,18,66,76,11,65
18,Elementary,Male,White,No,0,2766,568,2198,2583,279,2304
18,Elementary,Male,White,No,1,396,73,323,443,36,407
18,Elementary,Male,White,Yes,0,1592,318,1274,1483,148,1335
18,Elementary,Male,White,Yes,1,40,8,32,44,6,38
18,High,Female,Black,No,0,3126,475,2651,3201,370,2831
18,High,Female,Black,No,1,478,38,440,657,34,623
18,High,Female,Black,Yes,0,680,114,566,656,97,559
18,High,Female,Black,Yes,1,58,1,57,56,0,56
18,High,Female,Hispanic,No,0,528,85,443,525,59,466
18,High,Female,Hispanic,No,1,310,73,237,365,91,274
18,High,Female,Hispanic,Yes,0,74,12,62,72,7,65
18,High,Female,Hispanic,Yes,1,80,6,74,72,15,57
18,High,Female,Other,No,0,315,45,270,316,30,286
18,High,Female,Other,No,1,765,66,699,784,61,723
18,High,Female,Other,Yes,0,48,5,43,40,6,34
18,High,Female,Other,Yes,1,20,2,18,27,1,26
18,High,Female,White,No,0,1506,239,1267,1480,182,1298
18,High,Female,White,No,1,160,16,144,176,16,160
18,High,Female,White,Yes,0,428,76,352,337,53,284
18,High,Male,Black,No,0,2789,413,2376,2552,242,2310
18,High,Male,Black,No,1,496,27,469,604,27,577
18,High,Male,Black,Yes,0,1130,164,966,1098,138,960
18,High,Male,Black,Yes,1,48,5,43,64,5,59
18,High,Male,Hispanic,No,0,354,66,288,319,35,284
18,High,Male,Hispanic,No,1,369,90,279,353,49,304
18,High,Male,Hispanic,Yes,0,104,24,80,117,20,97
18,High,Male,Hispanic,Yes,1,152,23,129,164,35,129
18,High,Male,Other,No,0,216,23,193,259,30,229
18,High,Male,Other,No,1,790,62,728,748,55,693
18,High,Male,Other,Yes,0,120,20,100,104,8,96
18,High,Male,Other,Yes,1,28,3,25,28,0,28
18,High,Male,White,No,0,1200,172,1028,1204,127,1077
18,High,Male,White,No,1,204,31,173,216,29,187
18,High,Male,White,Yes,0,487,78,409,421,52,369
18,High,Male,White,Yes,1,8,0,8,4,0,4
18,Middle,Female,Black,No,0,2045,136,1909,2573,107,2466
18,Middle,Female,Black,No,1,304,8,296,453,10,443
18,Middle,Female,Black,Yes,0,379,27,352,432,18,414
18,Middle,Female,Black,Yes,1,28,4,24,44,1,43
18,Middle,Female,Hispanic,No,0,324,29,295,408,15,393
18,Middle,Female,Hispanic,No,1,188,16,172,204,10,194
18,Middle,Female,Hispanic,Yes,0,40,4,36,72,4,68
18,Middle,Female,Hispanic,Yes,1,40,5,35,64,6,58
18,Middle,Female,Other,No,0,260,31,229,286,13,273
18,Middle,Female,Other,No,1,412,19,393,492,5,487
18,Middle,Female,Other,Yes,0,56,9,47,52,11,41
18,Middle,Female,Other,Yes,1,8,1,7,4,0,4
18,Middle,Female,White,No,0,1168,90,1078,1233,54,1179
18,Middle,Female,White,No,1,116,9,107,136,2,134
18,Middle,Female,White,Yes,0,235,22,213,276,16,260
18,Middle,Female,White,Yes,1,4,0,4,8,0,8
18,Middle,Male,Black,No,0,1796,109,1687,2326,74,2252
18,Middle,Male,Black,No,1,287,13,274,476,7,469
18,Middle,Male,Black,Yes,0,895,66,829,1020,50,970
18,Middle,Male,Black,Yes,1,56,2,54,52,3,49
18,Middle,Male,Hispanic,No,0,255,30,225,384,29,355
18,Middle,Male,Hispanic,No,1,163,14,149,148,3,145
18,Middle,Male,Hispanic,Yes,0,164,18,146,164,4,160
18,Middle,Male,Hispanic,Yes,1,48,9,39,116,12,104
18,Middle,Male,Other,No,0,264,26,238,312,20,292
18,Middle,Male,Other,No,1,456,25,431,481,13,468
18,Middle,Male,Other,Yes,0,80,8,72,72,6,66
18,Middle,Male,Other,Yes,1,44,1,43,60,2,58
18,Middle,Male,White,No,0,1173,129,1044,1164,51,1113
18,Middle,Male,White,No,1,132,6,126,188,8,180
18,Middle,Male,White,Yes,0,500,55,445,633,41,592
18,Middle,Male,White,Yes,1,12,0,12,4,0,4
18,Other,Female,Black,No,0,1979,379,1600,2277,305,1972
18,Other,Female,Black,No,1,178,19,159,128,10,118
18,Other,Female,Black,Yes,0,252,51,201,347,45,302
18,Other,Female,Black,Yes,1,8,1,7,8,0,8
18,Other,Female,Hispanic,No,0,597,156,441,709,108,601
18,Other,Female,Hispanic,No,1,716,186,530,756,96,660
18,Other,Female,Hispanic,Yes,0,72,11,61,84,7,77
18,Other,Female,Hispanic,Yes,1,182,34,148,164,24,140
18,Other,Female,Other,No,0,262,53,209,373,41,332
18,Other,Female,Other,No,1,211,7,204,168,7,161
18,Other,Female,Other,Yes,0,38,8,30,39,3,36
18,Other,Female,Other,Yes,1,8,0,8,8,0,8
18,Other,Female,White,No,0,518,104,414,672,100,572
18,Other,Female,White,No,1,44,6,38,52,6,46
18,Other,Female,White,Yes,0,120,27,93,190,33,157
18,Other,Female,White,Yes,1,8,1,7,8,3,5
18,Other,Male,Black,No,0,1918,322,1596,2258,251,2007
18,Other,Male,Black,No,1,130,17,113,164,14,150
18,Other,Male,Black,Yes,0,709,123,586,763,109,654
18,Other,Male,Black,Yes,1,24,8,16,36,1,35
18,Other,Male,Hispanic,No,0,532,135,397,581,72,509
18,Other,Male,Hispanic,No,1,758,179,579,732,105,627
18,Other,Male,Hispanic,Yes,0,216,64,152,243,50,193
18,Other,Male,Hispanic,Yes,1,448,105,343,406,70,336
18,Other,Male,Other,No,0,206,36,170,325,35,290
18,Other,Male,Other,No,1,207,6,201,148,5,143
18,Other,Male,Other,Yes,0,108,19,89,120,15,105
18,Other,Male,Other,Yes,1,5,0,5,4,0,4
18,Other,Male,White,No,0,670,130,540,768,97,671
18,Other,Male,White,No,1,20,0,20,44,8,36
18,Other,Male,White,Yes,0,364,66,298,413,74,339
18,Other,Male,White,Yes,1,16,3,13,28,6,22
19,Elementary,Female,Black,No,0,6548,631,5917,4688,548,4140
19,Elementary,Female,Black,No,1,908,59,849,819,59,760
19,Elementary,Female,Black,Yes,0,1220,149,1071,837,107,730
19,Elementary,Female,Black,Yes,1,40,4,36,21,1,20
19,Elementary,Female,Hispanic,No,0,1046,96,950,761,102,659
19,Elementary,Female,Hispanic,No,1,292,40,252,189,22,167
19,Elementary,Female,Hispanic,Yes,0,200,16,184,171,26,145
19,Elementary,Female,Hispanic,Yes,1,100,17,83,81,17,64
19,Elementary,Female,Other,No,0,1552,190,1362,1305,165,1140
19,Elementary,Female,Other,No,1,1144,77,1067,860,52,808
19,Elementary,Female,Other,Yes,0,256,38,218,219,28,191
19,Elementary,Female,Other,Yes,1,36,8,28,42,2,40
19,Elementary,Female,White,No,0,3250,276,2974,2294,249,2045
19,Elementary,Female,White,No,1,341,24,317,282,27,255
19,Elementary,Female,White,Yes,0,890,103,787,606,92,514
19,Elementary,Female,White,Yes,1,20,1,19,12,0,12
19,Elementary,Male,Black,No,0,6012,525,5487,4399,502,3897
19,Elementary,Male,Black,No,1,905,67,838,762,35,727
19,Elementary,Male,Black,Yes,0,2530,278,2252,1944,227,1717
19,Elementary,Male,Black,Yes,1,126,14,112,78,10,68
19,Elementary,Male,Hispanic,No,0,1006,134,872,755,89,666
19,Elementary,Male,Hispanic,No,1,308,35,273,246,37,209
19,Elementary,Male,Hispanic,Yes,0,366,52,314,309,61,248
19,Elementary,Male,Hispanic,Yes,1,140,26,114,90,26,64
19,Elementary,Male,Other,No,0,1404,128,1276,1189,143,1046
19,Elementary,Male,Other,No,1,1300,100,1200,1015,41,974
19,Elementary,Male,Other,Yes,0,499,61,438,437,58,379
19,Elementary,Male,Other,Yes,1,84,10,74,57,6,51
19,Elementary,Male,White,No,0,2772,259,2513,1927,213,1714
19,Elementary,Male,White,No,1,398,37,361,330,34,296
19,Elementary,Male,White,Yes,0,1596,161,1435,1117,138,979
19,Elementary,Male,White,Yes,1,40,13,27,33,4,29
19,High,Female,Black,No,0,3134,217,2917,2403,225,2178
19,High,Female,Black,No,1,480,28,452,496,25,471
19,High,Female,Black,Yes,0,677,66,611,494,75,419
19,High,Female,Black,Yes,1,60,1,59,42,1,41
19,High,Female,Hispanic,No,0,531,51,480,394,48,346
19,High,Female,Hispanic,No,1,308,54,254,266,57,209
19,High,Female,Hispanic,Yes,0,76,9,67,52,6,46
19,High,Female,Hispanic,Yes,1,77,14,63,54,12,42
19,High,Female,Other,No,0,315,40,275,237,28,209
19,High,Female,Other,No,1,768,62,706,587,26,561
19,High,Female,Other,Yes,0,48,3,45,30,9,21
19,High,Female,Other,Yes,1,20,4,16,19,1,18
19,High,Female,White,No,0,1506,183,1323,1111,113,998
19,High,Female,White,No,1,160,8,152,134,7,127
19,High,Female,White,Yes,0,428,56,372,256,46,210
19,High,Male,Black,No,0,2780,217,2563,1907,171,1736
19,High,Male,Black,No,1,496,18,478,453,18,435
19,High,Male,Black,Yes,0,1133,114,1019,827,113,714
19,High,Male,Black,Yes,1,48,2,46,48,4,44
19,High,Male,Hispanic,No,0,344,34,310,237,26,211
19,High,Male,Hispanic,No,1,369,42,327,264,30,234
19,High,Male,Hispanic,Yes,0,104,16,88,90,21,69
19,High,Male,Hispanic,Yes,1,152,24,128,123,24,99
19,High,Male,Other,No,0,216,12,204,194,19,175
19,High,Male,Other,No,1,788,65,723,565,39,526
19,High,Male,Other,Yes,0,120,8,112,78,10,68
19,High,Male,Other,Yes,1,28,0,28,21,0,21
19,High,Male,White,No,0,1201,118,1083,903,81,822
19,High,Male,White,No,1,206,31,175,162,22,140
19,High,Male,White,Yes,0,478,60,418,313,46,267
19,High,Male,White,Yes,1,4,0,4,3,1,2
19,Middle,Female,Black,No,0,2045,66,1979,1937,91,1846
19,Middle,Female,Black,No,1,304,10,294,342,4,338
19,Middle,Female,Black,Yes,0,376,12,364,321,25,296
19,Middle,Female,Black,Yes,1,28,2,26,33,1,32
19,Middle,Female,Hispanic,No,0,324,19,305,306,18,288
19,Middle,Female,Hispanic,No,1,184,6,178,151,11,140
19,Middle,Female,Hispanic,Yes,0,40,2,38,54,2,52
19,Middle,Female,Hispanic,Yes,1,40,4,36,48,3,45
19,Middle,Female,Other,No,0,260,16,244,216,15,201
19,Middle,Female,Other,No,1,412,4,408,372,13,359
19,Middle,Female,Other,Yes,0,56,7,49,39,5,34
19,Middle,Female,Other,Yes,1,8,1,7,3,0,3
19,Middle,Female,White,No,0,1164,50,1114,926,53,873
19,Middle,Female,White,No,1,116,6,110,102,1,101
19,Middle,Female,White,Yes,0,234,12,222,207,16,191
19,Middle,Female,White,Yes,1,4,0,4,6,0,6
19,Middle,Male,Black,No,0,1804,66,1738,1747,78,1669
19,Middle,Male,Black,No,1,280,7,273,360,4,356
19,Middle,Male,Black,Yes,0,896,33,863,768,67,701
19,Middle,Male,Black,Yes,1,56,1,55,39,1,38
19,Middle,Male,Hispanic,No,0,256,18,238,288,24,264
19,Middle,Male,Hispanic,No,1,168,10,158,111,2,109
19,Middle,Male,Hispanic,Yes,0,161,5,156,123,12,111
19,Middle,Male,Hispanic,Yes,1,48,8,40,90,8,82
19,Middle,Male,Other,No,0,264,9,255,236,19,217
19,Middle,Male,Other,No,1,456,16,440,363,11,352
19,Middle,Male,Other,Yes,0,80,2,78,54,9,45
19,Middle,Male,Other,Yes,1,44,0,44,45,2,43
19,Middle,Male,White,No,0,1172,48,1124,871,55,816
19,Middle,Male,White,No,1,133,9,124,141,5,136
19,Middle,Male,White,Yes,0,500,27,473,476,50,426
19,Middle,Male,White,Yes,1,12,0,12,3,0,3
19,Other,Female,Black,No,0,1986,203,1783,1701,204,1497
19,Other,Female,Black,No,1,170,8,162,96,11,85
19,Other,Female,Black,Yes,0,252,48,204,258,36,222
19,Other,Female,Black,Yes,1,8,0,8,6,1,5
19,Other,Female,Hispanic,No,0,597,94,503,532,85,447
19,Other,Female,Hispanic,No,1,716,115,601,570,85,485
19,Other,Female,Hispanic,Yes,0,72,10,62,63,9,54
19,Other,Female,Hispanic,Yes,1,180,22,158,123,18,105
19,Other,Female,Other,No,0,256,31,225,290,24,266
19,Other,Female,Other,No,1,197,12,185,126,3,123
19,Other,Female,Other,Yes,0,36,2,34,30,2,28
19,Other,Female,Other,Yes,1,8,0,8,6,0,6
19,Other,Female,White,No,0,520,56,464,501,78,423
19,Other,Female,White,No,1,44,6,38,39,3,36
19,Other,Female,White,Yes,0,125,12,113,141,22,119
19,Other,Female,White,Yes,1,8,2,6,6,1,5
19,Other,Male,Black,No,0,1922,189,1733,1685,182,1503
19,Other,Male,Black,No,1,132,5,127,123,19,104
19,Other,Male,Black,Yes,0,701,87,614,568,80,488
19,Other,Male,Black,Yes,1,24,5,19,27,2,25
19,Other,Male,Hispanic,No,0,533,78,455,437,67,370
19,Other,Male,Hispanic,No,1,759,95,664,543,79,464
19,Other,Male,Hispanic,Yes,0,216,29,187,180,48,132
19,Other,Male,Hispanic,Yes,1,446,61,385,303,53,250
19,Other,Male,Other,No,0,204,20,184,247,21,226
19,Other,Male,Other,No,1,192,9,183,113,1,112
19,Other,Male,Other,Yes,0,108,15,93,88,11,77
19,Other,Male,Other,Yes,1,4,0,4,3,0,3
19,Other,Male,White,No,0,670,78,592,576,62,514
19,Other,Male,White,No,1,20,1,19,33,4,29
19,Other,Male,White,Yes,0,364,51,313,306,49,257
19,Other,Male,White,Yes,1,16,2,14,21,4,17
20,Elementary,Female,Black,No,0,8198,859,7339,7813,571,7242
20,Elementary,Female,Black,No,1,1135,58,1077,1377,60,1317
20,Elementary,Female,Black,Yes,0,1525,189,1336,1397,90,1307
20,Elementary,Female,Black,Yes,1,50,4,46,35,0,35
20,Elementary,Female,Hispanic,No,0,1313,148,1165,1270,127,1143
20,Elementary,Female,Hispanic,No,1,364,50,314,318,31,287
20,Elementary,Female,Hispanic,Yes,0,250,28,222,285,43,242
20,Elementary,Female,Hispanic,Yes,1,125,17,108,135,8,127
20,Elementary,Female,Other,No,0,1941,249,1692,2176,192,1984
20,Elementary,Female,Other,No,1,1430,76,1354,1443,63,1380
20,Elementary,Female,Other,Yes,0,320,37,283,365,34,331
20,Elementary,Female,Other,Yes,1,45,7,38,70,13,57
20,Elementary,Female,White,No,0,4062,416,3646,3826,320,3506
20,Elementary,Female,White,No,1,425,35,390,473,25,448
20,Elementary,Female,White,Yes,0,1110,129,981,1002,96,906
20,Elementary,Female,White,Yes,1,25,3,22,20,0,20
20,Elementary,Male,Black,No,0,7521,683,6838,7331,558,6773
20,Elementary,Male,Black,No,1,1130,68,1062,1273,49,1224
20,Elementary,Male,Black,Yes,0,3157,330,2827,3237,277,2960
20,Elementary,Male,Black,Yes,1,160,14,146,130,16,114
20,Elementary,Male,Hispanic,No,0,1258,129,1129,1255,103,1152
20,Elementary,Male,Hispanic,No,1,379,37,342,410,46,364
20,Elementary,Male,Hispanic,Yes,0,457,68,389,515,75,440
20,Elementary,Male,Hispanic,Yes,1,175,28,147,150,22,128
20,Elementary,Male,Other,No,0,1756,183,1573,1985,189,1796
20,Elementary,Male,Other,No,1,1625,90,1535,1698,85,1613
20,Elementary,Male,Other,Yes,0,616,90,526,726,71,655
20,Elementary,Male,Other,Yes,1,105,12,93,95,8,87
20,Elementary,Male,White,No,0,3459,336,3123,3221,244,2977
20,Elementary,Male,White,No,1,497,53,444,550,36,514
20,Elementary,Male,White,Yes,0,1995,226,1769,1860,195,1665
20,Elementary,Male,White,Yes,1,50,17,33,55,3,52
20,High,Female,Black,No,0,3919,241,3678,4000,335,3665
20,High,Female,Black,No,1,600,14,586,829,25,804
20,High,Female,Black,Yes,0,839,61,778,822,93,729
20,High,Female,Black,Yes,1,75,1,74,70,1,69
20,High,Female,Hispanic,No,0,662,56,606,655,77,578
20,High,Female,Hispanic,No,1,380,40,340,446,70,376
20,High,Female,Hispanic,Yes,0,95,10,85,87,15,72
20,High,Female,Hispanic,Yes,1,95,7,88,90,10,80
20,High,Female,Other,No,0,386,40,346,394,48,346
20,High,Female,Other,No,1,960,41,919,981,61,920
20,High,Female,Other,Yes,0,60,3,57,55,9,46
20,High,Female,Other,Yes,1,25,2,23,32,1,31
20,High,Female,White,No,0,1879,151,1728,1852,181,1671
20,High,Female,White,No,1,205,8,197,225,15,210
20,High,Female,White,Yes,0,536,50,486,427,59,368
20,High,Male,Black,No,0,3460,232,3228,3181,260,2921
20,High,Male,Black,No,1,621,18,603,760,14,746
20,High,Male,Black,Yes,0,1407,106,1301,1371,166,1205
20,High,Male,Black,Yes,1,60,0,60,80,2,78
20,High,Male,Hispanic,No,0,418,30,388,395,46,349
20,High,Male,Hispanic,No,1,455,42,413,438,56,382
20,High,Male,Hispanic,Yes,0,130,15,115,150,23,127
20,High,Male,Hispanic,Yes,1,190,18,172,205,32,173
20,High,Male,Other,No,0,272,20,252,326,26,300
20,High,Male,Other,No,1,985,46,939,945,44,901
20,High,Male,Other,Yes,0,150,18,132,130,16,114
20,High,Male,Other,Yes,1,35,2,33,35,0,35
20,High,Male,White,No,0,1498,118,1380,1495,126,1369
20,High,Male,White,No,1,265,20,245,275,36,239
20,High,Male,White,Yes,0,591,45,546,521,57,464
20,High,Male,White,Yes,1,5,0,5,5,0,5
20,Middle,Female,Black,No,0,2556,78,2478,3228,113,3115
20,Middle,Female,Black,No,1,380,11,369,573,4,569
20,Middle,Female,Black,Yes,0,470,15,455,536,24,512
20,Middle,Female,Black,Yes,1,35,1,34,55,1,54
20,Middle,Female,Hispanic,No,0,405,16,389,510,26,484
20,Middle,Female,Hispanic,No,1,225,9,216,250,9,241
20,Middle,Female,Hispanic,Yes,0,50,3,47,90,10,80
20,Middle,Female,Hispanic,Yes,1,50,2,48,80,12,68
20,Middle,Female,Other,No,0,325,10,315,360,14,346
20,Middle,Female,Other,No,1,515,7,508,625,16,609
20,Middle,Female,Other,Yes,0,70,8,62,65,11,54
20,Middle,Female,Other,Yes,1,10,1,9,5,0,5
20,Middle,Female,White,No,0,1453,72,1381,1542,93,1449
20,Middle,Female,White,No,1,148,3,145,175,4,171
20,Middle,Female,White,Yes,0,295,17,278,345,24,321
20,Middle,Female,White,Yes,1,5,0,5,10,1,9
20,Middle,Male,Black,No,0,2247,63,2184,2910,112,2798
20,Middle,Male,Black,No,1,353,12,341,602,7,595
20,Middle,Male,Black,Yes,0,1119,30,1089,1285,79,1206
20,Middle,Male,Black,Yes,1,70,1,69,65,5,60
20,Middle,Male,Hispanic,No,0,320,13,307,479,21,458
20,Middle,Male,Hispanic,No,1,210,11,199,185,5,180
20,Middle,Male,Hispanic,Yes,0,200,9,191,205,23,182
20,Middle,Male,Hispanic,Yes,1,60,5,55,144,12,132
20,Middle,Male,Other,No,0,330,14,316,395,27,368
20,Middle,Male,Other,No,1,570,15,555,605,13,592
20,Middle,Male,Other,Yes,0,100,1,99,90,10,80
20,Middle,Male,Other,Yes,1,55,2,53,75,4,71
20,Middle,Male,White,No,0,1465,71,1394,1447,94,1353
20,Middle,Male,White,No,1,173,7,166,235,7,228
20,Middle,Male,White,Yes,0,625,41,584,790,87,703
20,Middle,Male,White,Yes,1,15,1,14,5,0,5
20,Other,Female,Black,No,0,2477,265,2212,2847,272,2575
20,Other,Female,Black,No,1,210,20,190,160,11,149
20,Other,Female,Black,Yes,0,312,48,264,434,71,363
20,Other,Female,Black,Yes,1,10,0,10,10,0,10
20,Other,Female,Hispanic,No,0,738,107,631,890,98,792
20,Other,Female,Hispanic,No,1,895,164,731,944,104,840
20,Other,Female,Hispanic,Yes,0,90,14,76,105,7,98
20,Other,Female,Hispanic,Yes,1,229,21,208,200,33,167
20,Other,Female,Other,No,0,320,27,293,488,41,447
20,Other,Female,Other,No,1,250,12,238,210,7,203
20,Other,Female,Other,Yes,0,45,2,43,50,6,44
20,Other,Female,Other,Yes,1,10,0,10,10,0,10
20,Other,Female,White,No,0,648,66,582,837,99,738
20,Other,Female,White,No,1,55,7,48,70,4,66
20,Other,Female,White,Yes,0,160,17,143,235,43,192
20,Other,Female,White,Yes,1,10,2,8,10,0,10
20,Other,Male,Black,No,0,2412,235,2177,2827,225,2602
20,Other,Male,Black,No,1,165,12,153,205,17,188
20,Other,Male,Black,Yes,0,882,98,784,957,98,859
20,Other,Male,Black,Yes,1,30,9,21,45,3,42
20,Other,Male,Hispanic,No,0,665,88,577,727,89,638
20,Other,Male,Hispanic,No,1,946,149,797,915,107,808
20,Other,Male,Hispanic,Yes,0,270,49,221,300,42,258
20,Other,Male,Hispanic,Yes,1,564,74,490,507,65,442
20,Other,Male,Other,No,0,255,35,220,424,29,395
20,Other,Male,Other,No,1,240,11,229,190,4,186
20,Other,Male,Other,Yes,0,131,18,113,141,16,125
20,Other,Male,Other,Yes,1,5,3,2,5,0,5
20,Other,Male,White,No,0,822,86,736,965,90,875
20,Other,Male,White,No,1,25,0,25,55,6,49
20,Other,Male,White,Yes,0,451,69,382,500,80,420
20,Other,Male,White,Yes,1,20,4,16,35,5,30
21,Elementary,Female,Black,No,0,6552,746,5806,6247,488,5759
21,Elementary,Female,Black,No,1,908,59,849,1108,38,1070
21,Elementary,Female,Black,Yes,0,1220,166,1054,1122,96,1026
21,Elementary,Female,Black,Yes,1,40,3,37,28,1,27
21,Elementary,Female,Hispanic,No,0,1048,122,926,1018,119,899
21,Elementary,Female,Hispanic,No,1,288,36,252,256,30,226
21,Elementary,Female,Hispanic,Yes,0,200,25,175,228,32,196
21,Elementary,Female,Hispanic,Yes,1,100,16,84,108,15,93
21,Elementary,Female,Other,No,0,1554,217,1337,1738,149,1589
21,Elementary,Female,Other,No,1,1144,99,1045,1156,59,1097
21,Elementary,Female,Other,Yes,0,254,35,219,292,29,263
21,Elementary,Female,Other,Yes,1,36,1,35,56,5,51
21,Elementary,Female,White,No,0,3245,376,2869,3062,233,2829
21,Elementary,Female,White,No,1,342,31,311,380,18,362
21,Elementary,Female,White,Yes,0,888,105,783,797,99,698
21,Elementary,Female,White,Yes,1,20,0,20,16,1,15
21,Elementary,Male,Black,No,0,6018,669,5349,5865,454,5411
21,Elementary,Male,Black,No,1,901,58,843,1020,37,983
21,Elementary,Male,Black,Yes,0,2537,391,2146,2582,246,2336
21,Elementary,Male,Black,Yes,1,128,2,126,104,11,93
21,Elementary,Male,Hispanic,No,0,1009,150,859,994,83,911
21,Elementary,Male,Hispanic,No,1,304,46,258,328,38,290
21,Elementary,Male,Hispanic,Yes,0,364,63,301,412,67,345
21,Elementary,Male,Hispanic,Yes,1,140,27,113,120,23,97
21,Elementary,Male,Other,No,0,1406,155,1251,1588,114,1474
21,Elementary,Male,Other,No,1,1300,86,1214,1362,64,1298
21,Elementary,Male,Other,Yes,0,490,71,419,571,62,509
21,Elementary,Male,Other,Yes,1,84,14,70,76,12,64
21,Elementary,Male,White,No,0,2760,348,2412,2579,271,2308
21,Elementary,Male,White,No,1,394,47,347,440,23,417
21,Elementary,Male,White,Yes,0,1599,220,1379,1487,152,1335
21,Elementary,Male,White,Yes,1,40,11,29,44,2,42
21,High,Female,Black,No,0,3127,219,2908,3132,341,2791
21,High,Female,Black,No,1,480,19,461,658,18,640
21,High,Female,Black,Yes,0,658,49,609,646,101,545
21,High,Female,Black,Yes,1,60,4,56,56,1,55
21,High,Female,Hispanic,No,0,522,47,475,526,62,464
21,High,Female,Hispanic,No,1,307,41,266,350,64,286
21,High,Female,Hispanic,Yes,0,76,9,67,72,11,61
21,High,Female,Hispanic,Yes,1,76,7,69,72,13,59
21,High,Female,Other,No,0,305,30,275,312,23,289
21,High,Female,Other,No,1,756,62,694,781,50,731
21,High,Female,Other,Yes,0,48,8,40,44,10,34
21,High,Female,Other,Yes,1,17,1,16,26,1,25
21,High,Female,White,No,0,1494,148,1346,1485,125,1360
21,High,Female,White,No,1,164,12,152,176,10,166
21,High,Female,White,Yes,0,428,49,379,342,69,273
21,High,Male,Black,No,0,2750,186,2564,2491,239,2252
21,High,Male,Black,No,1,500,12,488,600,17,583
21,High,Male,Black,Yes,0,1112,89,1023,1086,147,939
21,High,Male,Black,Yes,1,48,1,47,68,4,64
21,High,Male,Hispanic,No,0,330,30,300,308,33,275
21,High,Male,Hispanic,No,1,358,37,321,341,26,315
21,High,Male,Hispanic,Yes,0,104,11,93,120,23,97
21,High,Male,Hispanic,Yes,1,152,21,131,164,30,134
21,High,Male,Other,No,0,220,11,209,264,17,247
21,High,Male,Other,No,1,778,40,738,760,39,721
21,High,Male,Other,Yes,0,120,9,111,100,9,91
21,High,Male,Other,Yes,1,28,1,27,28,0,28
21,High,Male,White,No,0,1183,80,1103,1188,93,1095
21,High,Male,White,No,1,212,23,189,220,26,194
21,High,Male,White,Yes,0,471,36,435,406,54,352
21,High,Male,White,Yes,1,4,0,4,4,0,4
21,Middle,Female,Black,No,0,2034,69,1965,2584,106,2478
21,Middle,Female,Black,No,1,304,5,299,468,7,461
21,Middle,Female,Black,Yes,0,376,10,366,432,34,398
21,Middle,Female,Black,Yes,1,28,0,28,44,3,41
21,Middle,Female,Hispanic,No,0,324,23,301,404,30,374
21,Middle,Female,Hispanic,No,1,180,6,174,204,5,199
21,Middle,Female,Hispanic,Yes,0,40,1,39,72,5,67
21,Middle,Female,Hispanic,Yes,1,40,5,35,64,9,55
21,Middle,Female,Other,No,0,260,11,249,288,16,272
21,Middle,Female,Other,No,1,412,8,404,500,10,490
21,Middle,Female,Other,Yes,0,56,3,53,52,7,45
21,Middle,Female,Other,Yes,1,8,1,7,4,0,4
21,Middle,Female,White,No,0,1164,47,1117,1228,61,1167
21,Middle,Female,White,No,1,120,3,117,140,3,137
21,Middle,Female,White,Yes,0,232,12,220,275,17,258
21,Middle,Female,White,Yes,1,4,0,4,8,1,7
21,Middle,Male,Black,No,0,1792,52,1740,2328,96,2232
21,Middle,Male,Black,No,1,284,4,280,480,4,476
21,Middle,Male,Black,Yes,0,884,30,854,1030,39,991
21,Middle,Male,Black,Yes,1,56,0,56,52,3,49
21,Middle,Male,Hispanic,No,0,253,12,241,384,12,372
21,Middle,Male,Hispanic,No,1,168,5,163,148,3,145
21,Middle,Male,Hispanic,Yes,0,160,10,150,164,10,154
21,Middle,Male,Hispanic,Yes,1,48,3,45,112,5,107
21,Middle,Male,Other,No,0,264,7,257,316,30,286
21,Middle,Male,Other,No,1,456,10,446,485,8,477
21,Middle,Male,Other,Yes,0,80,5,75,72,8,64
21,Middle,Male,Other,Yes,1,44,1,43,60,4,56
21,Middle,Male,White,No,0,1173,67,1106,1152,55,1097
21,Middle,Male,White,No,1,140,6,134,188,4,184
21,Middle,Male,White,Yes,0,500,30,470,630,55,575
21,Middle,Male,White,Yes,1,12,0,12,4,0,4
21,Other,Female,Black,No,0,1969,241,1728,2300,203,2097
21,Other,Female,Black,No,1,158,9,149,129,7,122
21,Other,Female,Black,Yes,0,240,49,191,360,50,310
21,Other,Female,Black,Yes,1,8,0,8,8,0,8
21,Other,Female,Hispanic,No,0,595,96,499,705,76,629
21,Other,Female,Hispanic,No,1,724,141,583,756,88,668
21,Other,Female,Hispanic,Yes,0,72,11,61,84,10,74
21,Other,Female,Hispanic,Yes,1,182,20,162,164,16,148
21,Other,Female,Other,No,0,253,37,216,402,27,375
21,Other,Female,Other,No,1,200,12,188,168,1,167
21,Other,Female,Other,Yes,0,36,6,30,40,4,36
21,Other,Female,Other,Yes,1,8,0,8,8,0,8
21,Other,Female,White,No,0,513,51,462,682,77,605
21,Other,Female,White,No,1,44,2,42,56,6,50
21,Other,Female,White,Yes,0,125,16,109,191,30,161
21,Other,Female,White,Yes,1,8,1,7,8,2,6
21,Other,Male,Black,No,0,1937,225,1712,2280,199,2081
21,Other,Male,Black,No,1,136,9,127,167,13,154
21,Other,Male,Black,Yes,0,707,99,608,784,82,702
21,Other,Male,Black,Yes,1,24,6,18,32,4,28
21,Other,Male,Hispanic,No,0,536,93,443,584,57,527
21,Other,Male,Hispanic,No,1,756,139,617,731,103,628
21,Other,Male,Hispanic,Yes,0,216,52,164,240,48,192
21,Other,Male,Hispanic,Yes,1,452,82,370,409,58,351
21,Other,Male,Other,No,0,200,33,167,340,22,318
21,Other,Male,Other,No,1,192,13,179,151,12,139
21,Other,Male,Other,Yes,0,107,32,75,114,20,94
21,Other,Male,Other,Yes,1,4,1,3,4,0,4
21,Other,Male,White,No,0,652,76,576,781,76,705
21,Other,Male,White,No,1,22,1,21,48,8,40
21,Other,Male,White,Yes,0,358,62,296,393,51,342
21,Other,Male,White,Yes,1,16,2,14,28,9,19
22,Elementary,Female,Black,No,0,6553,1160,5393,7804,702,7102
22,Elementary,Female,Black,No,1,913,70,843,1403,43,1360
22,Elementary,Female,Black,Yes,0,1220,237,983,1405,142,1263
22,Elementary,Female,Black,Yes,1,40,3,37,35,1,34
22,Elementary,Female,Hispanic,No,0,1048,201,847,1272,119,1153
22,Elementary,Female,Hispanic,No,1,288,59,229,325,24,301
22,Elementary,Female,Hispanic,Yes,0,200,43,157,285,55,230
22,Elementary,Female,Hispanic,Yes,1,100,19,81,135,19,116
22,Elementary,Female,Other,No,0,1553,301,1252,2178,202,1976
22,Elementary,Female,Other,No,1,1144,79,1065,1439,70,1369
22,Elementary,Female,Other,Yes,0,252,57,195,365,50,315
22,Elementary,Female,Other,Yes,1,36,6,30,70,11,59
22,Elementary,Female,White,No,0,3252,515,2737,3836,359,3477
22,Elementary,Female,White,No,1,345,45,300,475,25,450
22,Elementary,Female,White,Yes,0,888,151,737,995,105,890
22,Elementary,Female,White,Yes,1,20,1,19,20,0,20
22,Elementary,Male,Black,No,0,6018,1032,4986,7339,579,6760
22,Elementary,Male,Black,No,1,900,78,822,1280,48,1232
22,Elementary,Male,Black,Yes,0,2545,503,2042,3228,337,2891
22,Elementary,Male,Black,Yes,1,128,10,118,130,18,112
22,Elementary,Male,Hispanic,No,0,1005,191,814,1237,129,1108
22,Elementary,Male,Hispanic,No,1,308,59,249,410,40,370
22,Elementary,Male,Hispanic,Yes,0,363,77,286,515,72,443
22,Elementary,Male,Hispanic,Yes,1,140,32,108,150,27,123
22,Elementary,Male,Other,No,0,1404,261,1143,1985,218,1767
22,Elementary,Male,Other,No,1,1299,102,1197,1701,89,1612
22,Elementary,Male,Other,Yes,0,492,99,393,710,82,628
22,Elementary,Male,Other,Yes,1,84,12,72,95,13,82
22,Elementary,Male,White,No,0,2765,424,2341,3210,319,2891
22,Elementary,Male,White,No,1,392,72,320,550,54,496
22,Elementary,Male,White,Yes,0,1604,308,1296,1858,189,1669
22,Elementary,Male,White,Yes,1,40,13,27,55,5,50
22,High,Female,Black,No,0,3105,310,2795,3907,464,3443
22,High,Female,Black,No,1,481,33,448,825,24,801
22,High,Female,Black,Yes,0,641,71,570,805,116,689
22,High,Female,Black,Yes,1,63,2,61,70,1,69
22,High,Female,Hispanic,No,0,514,71,443,660,86,574
22,High,Female,Hispanic,No,1,307,57,250,439,98,341
22,High,Female,Hispanic,Yes,0,75,13,62,83,14,69
22,High,Female,Hispanic,Yes,1,75,16,59,88,18,70
22,High,Female,Other,No,0,301,23,278,389,40,349
22,High,Female,Other,No,1,749,56,693,979,69,910
22,High,Female,Other,Yes,0,46,3,43,55,10,45
22,High,Female,Other,Yes,1,16,0,16,33,1,32
22,High,Female,White,No,0,1490,175,1315,1850,187,1663
22,High,Female,White,No,1,164,15,149,220,20,200
22,High,Female,White,Yes,0,415,54,361,426,77,349
22,High,Male,Black,No,0,2709,253,2456,3090,308,2782
22,High,Male,Black,No,1,499,22,477,750,19,731
22,High,Male,Black,Yes,0,1086,142,944,1363,195,1168
22,High,Male,Black,Yes,1,47,3,44,85,4,81
22,High,Male,Hispanic,No,0,331,34,297,386,28,358
22,High,Male,Hispanic,No,1,350,56,294,425,47,378
22,High,Male,Hispanic,Yes,0,98,8,90,150,29,121
22,High,Male,Hispanic,Yes,1,150,26,124,204,37,167
22,High,Male,Other,No,0,220,17,203,327,28,299
22,High,Male,Other,No,1,772,46,726,950,84,866
22,High,Male,Other,Yes,0,120,11,109,124,9,115
22,High,Male,Other,Yes,1,27,1,26,35,2,33
22,High,Male,White,No,0,1177,108,1069,1485,127,1358
22,High,Male,White,No,1,212,28,184,273,35,238
22,High,Male,White,Yes,0,462,60,402,504,73,431
22,High,Male,White,Yes,1,4,0,4,5,0,5
22,Middle,Female,Black,No,0,2037,109,1928,3235,104,3131
22,Middle,Female,Black,No,1,306,5,301,585,3,582
22,Middle,Female,Black,Yes,0,376,21,355,539,35,504
22,Middle,Female,Black,Yes,1,28,0,28,55,0,55
22,Middle,Female,Hispanic,No,0,323,17,306,500,37,463
22,Middle,Female,Hispanic,No,1,180,8,172,255,9,246
22,Middle,Female,Hispanic,Yes,0,40,3,37,90,10,80
22,Middle,Female,Hispanic,Yes,1,40,4,36,80,4,76
22,Middle,Female,Other,No,0,262,11,251,357,12,345
22,Middle,Female,Other,No,1,412,12,400,625,9,616
22,Middle,Female,Other,Yes,0,56,8,48,65,7,58
22,Middle,Female,Other,Yes,1,8,1,7,5,1,4
22,Middle,Female,White,No,0,1160,55,1105,1535,80,1455
22,Middle,Female,White,No,1,120,3,117,183,4,179
22,Middle,Female,White,Yes,0,229,17,212,340,20,320
22,Middle,Female,White,Yes,1,4,1,3,10,0,10
22,Middle,Male,Black,No,0,1794,57,1737,2923,120,2803
22,Middle,Male,Black,No,1,284,6,278,604,5,599
22,Middle,Male,Black,Yes,0,884,40,844,1290,52,1238
22,Middle,Male,Black,Yes,1,56,3,53,65,1,64
22,Middle,Male,Hispanic,No,0,251,7,244,480,29,451
22,Middle,Male,Hispanic,No,1,168,14,154,185,6,179
22,Middle,Male,Hispanic,Yes,0,160,8,152,205,13,192
22,Middle,Male,Hispanic,Yes,1,48,4,44,140,6,134
22,Middle,Male,Other,No,0,268,9,259,391,24,367
22,Middle,Male,Other,No,1,456,7,449,610,14,596
22,Middle,Male,Other,Yes,0,80,7,73,90,10,80
22,Middle,Male,Other,Yes,1,44,1,43,75,5,70
22,Middle,Male,White,No,0,1178,58,1120,1439,95,1344
22,Middle,Male,White,No,1,140,7,133,235,5,230
22,Middle,Male,White,Yes,0,500,33,467,781,71,710
22,Middle,Male,White,Yes,1,12,0,12,5,0,5
22,Other,Female,Black,No,0,1992,284,1708,2903,297,2606
22,Other,Female,Black,No,1,156,14,142,168,15,153
22,Other,Female,Black,Yes,0,240,36,204,459,80,379
22,Other,Female,Black,Yes,1,8,1,7,10,0,10
22,Other,Female,Hispanic,No,0,598,121,477,889,96,793
22,Other,Female,Hispanic,No,1,720,158,562,947,118,829
22,Other,Female,Hispanic,Yes,0,72,12,60,105,12,93
22,Other,Female,Hispanic,Yes,1,180,37,143,205,18,187
22,Other,Female,Other,No,0,254,36,218,508,37,471
22,Other,Female,Other,No,1,200,7,193,210,11,199
22,Other,Female,Other,Yes,0,38,5,33,50,6,44
22,Other,Female,Other,Yes,1,8,0,8,10,0,10
22,Other,Female,White,No,0,515,61,454,860,105,755
22,Other,Female,White,No,1,44,4,40,70,3,67
22,Other,Female,White,Yes,0,125,17,108,240,44,196
22,Other,Female,White,Yes,1,8,5,3,10,2,8
22,Other,Male,Black,No,0,1963,232,1731,2882,291,2591
22,Other,Male,Black,No,1,136,15,121,215,14,201
22,Other,Male,Black,Yes,0,717,118,599,990,153,837
22,Other,Male,Black,Yes,1,24,5,19,40,1,39
22,Other,Male,Hispanic,No,0,542,113,429,738,78,660
22,Other,Male,Hispanic,No,1,767,177,590,922,126,796
22,Other,Male,Hispanic,Yes,0,220,65,155,300,57,243
22,Other,Male,Hispanic,Yes,1,452,99,353,515,74,441
22,Other,Male,Other,No,0,194,33,161,430,32,398
22,Other,Male,Other,No,1,192,10,182,185,6,179
22,Other,Male,Other,Yes,0,107,23,84,147,21,126
22,Other,Male,Other,Yes,1,4,0,4,5,0,5
22,Other,Male,White,No,0,653,85,568,970,106,864
22,Other,Male,White,No,1,24,3,21,60,9,51
22,Other,Male,White,Yes,0,361,53,308,492,72,420
22,Other,Male,White,Yes,1,16,3,13,35,5,30
23,Elementary,Female,Black,No,0,1638,142,1496,1560,242,1318
23,Elementary,Female,Black,No,1,229,21,208,283,29,254
23,Elementary,Female,Black,Yes,0,305,23,282,281,61,220
23,Elementary,Female,Black,Yes,1,10,0,10,7,0,7
23,Elementary,Female,Hispanic,No,0,262,28,234,255,32,223
23,Elementary,Female,Hispanic,No,1,72,8,64,65,10,55
23,Elementary,Female,Hispanic,Yes,0,50,6,44,56,9,47
23,Elementary,Female,Hispanic,Yes,1,25,2,23,27,6,21
23,Elementary,Female,Other,No,0,389,45,344,436,71,365
23,Elementary,Female,Other,No,1,286,21,265,287,22,265
23,Elementary,Female,Other,Yes,0,63,4,59,73,20,53
23,Elementary,Female,Other,Yes,1,9,2,7,14,3,11
23,Elementary,Female,White,No,0,814,60,754,768,94,674
23,Elementary,Female,White,No,1,87,4,83,93,12,81
23,Elementary,Female,White,Yes,0,222,17,205,199,32,167
23,Elementary,Female,White,Yes,1,5,0,5,4,0,4
23,Elementary,Male,Black,No,0,1503,128,1375,1468,261,1207
23,Elementary,Male,Black,No,1,225,14,211,260,26,234
23,Elementary,Male,Black,Yes,0,638,73,565,646,124,522
23,Elementary,Male,Black,Yes,1,32,2,30,26,5,21
23,Elementary,Male,Hispanic,No,0,251,36,215,247,45,202
23,Elementary,Male,Hispanic,No,1,76,5,71,83,13,70
23,Elementary,Male,Hispanic,Yes,0,90,16,74,103,25,78
23,Elementary,Male,Hispanic,Yes,1,35,7,28,30,11,19
23,Elementary,Male,Other,No,0,352,31,321,397,71,326
23,Elementary,Male,Other,No,1,326,14,312,340,34,306
23,Elementary,Male,Other,Yes,0,123,11,112,142,25,117
23,Elementary,Male,Other,Yes,1,21,1,20,19,3,16
23,Elementary,Male,White,No,0,693,58,635,642,105,537
23,Elementary,Male,White,No,1,98,16,82,110,19,91
23,Elementary,Male,White,Yes,0,401,41,360,372,59,313
23,Elementary,Male,White,Yes,1,10,2,8,11,2,9
23,High,Female,Black,No,0,771,52,719,778,161,617
23,High,Female,Black,No,1,121,4,117,166,12,154
23,High,Female,Black,Yes,0,158,14,144,161,38,123
23,High,Female,Black,Yes,1,16,0,16,14,1,13
23,High,Female,Hispanic,No,0,128,11,117,132,27,105
23,High,Female,Hispanic,No,1,78,10,68,87,19,68
23,High,Female,Hispanic,Yes,0,19,1,18,16,4,12
23,High,Female,Hispanic,Yes,1,19,3,16,17,6,11
23,High,Female,Other,No,0,75,7,68,77,9,68
23,High,Female,Other,No,1,187,19,168,197,20,177
23,High,Female,Other,Yes,0,11,0,11,11,4,7
23,High,Female,Other,Yes,1,4,0,4,6,0,6
23,High,Female,White,No,0,373,43,330,369,72,297
23,High,Female,White,No,1,41,1,40,44,8,36
23,High,Female,White,Yes,0,104,14,90,85,24,61
23,High,Male,Black,No,0,670,59,611,615,108,507
23,High,Male,Black,No,1,124,0,124,151,8,143
23,High,Male,Black,Yes,0,272,31,241,272,58,214
23,High,Male,Black,Yes,1,12,0,12,17,1,16
23,High,Male,Hispanic,No,0,83,10,73,78,13,65
23,High,Male,Hispanic,No,1,87,7,80,85,13,72
23,High,Male,Hispanic,Yes,0,24,4,20,30,6,24
23,High,Male,Hispanic,Yes,1,37,7,30,40,14,26
23,High,Male,Other,No,0,55,4,51,65,7,58
23,High,Male,Other,No,1,192,11,181,190,17,173
23,High,Male,Other,Yes,0,30,5,25,24,5,19
23,High,Male,Other,Yes,1,7,0,7,7,0,7
23,High,Male,White,No,0,294,20,274,297,45,252
23,High,Male,White,No,1,53,5,48,54,8,46
23,High,Male,White,Yes,0,116,14,102,101,20,81
23,High,Male,White,Yes,1,1,0,1,1,0,1
23,Middle,Female,Black,No,0,510,5,505,647,53,594
23,Middle,Female,Black,No,1,78,0,78,117,1,116
23,Middle,Female,Black,Yes,0,94,1,93,107,11,96
23,Middle,Female,Black,Yes,1,7,0,7,11,0,11
23,Middle,Female,Hispanic,No,0,80,4,76,100,10,90
23,Middle,Female,Hispanic,No,1,45,0,45,51,3,48
23,Middle,Female,Hispanic,Yes,0,10,0,10,18,5,13
23,Middle,Female,Hispanic,Yes,1,10,0,10,16,5,11
23,Middle,Female,Other,No,0,66,0,66,71,5,66
23,Middle,Female,Other,No,1,103,0,103,125,2,123
23,Middle,Female,Other,Yes,0,14,1,13,13,5,8
23,Middle,Female,Other,Yes,1,2,0,2,1,0,1
23,Middle,Female,White,No,0,290,9,281,307,24,283
23,Middle,Female,White,No,1,30,1,29,37,3,34
23,Middle,Female,White,Yes,0,57,1,56,68,5,63
23,Middle,Female,White,Yes,1,1,0,1,2,0,2
23,Middle,Male,Black,No,0,448,8,440,587,46,541
23,Middle,Male,Black,No,1,71,2,69,121,5,116
23,Middle,Male,Black,Yes,0,221,6,215,258,26,232
23,Middle,Male,Black,Yes,1,14,0,14,13,2,11
23,Middle,Male,Hispanic,No,0,62,0,62,96,12,84
23,Middle,Male,Hispanic,No,1,42,0,42,36,4,32
23,Middle,Male,Hispanic,Yes,0,40,0,40,41,7,34
23,Middle,Male,Hispanic,Yes,1,12,1,11,28,0,28
23,Middle,Male,Other,No,0,67,0,67,78,7,71
23,Middle,Male,Other,No,1,114,1,113,122,5,117
23,Middle,Male,Other,Yes,0,20,0,20,18,3,15
23,Middle,Male,Other,Yes,1,11,0,11,15,3,12
23,Middle,Male,White,No,0,295,5,290,287,26,261
23,Middle,Male,White,No,1,35,1,34,47,2,45
23,Middle,Male,White,Yes,0,125,4,121,157,24,133
23,Middle,Male,White,Yes,1,3,0,3,1,0,1
23,Other,Female,Black,No,0,500,36,464,584,99,485
23,Other,Female,Black,No,1,39,5,34,34,5,29
23,Other,Female,Black,Yes,0,59,10,49,92,23,69
23,Other,Female,Black,Yes,1,2,0,2,2,0,2
23,Other,Female,Hispanic,No,0,148,17,131,178,43,135
23,Other,Female,Hispanic,No,1,178,27,151,189,43,146
23,Other,Female,Hispanic,Yes,0,18,2,16,21,5,16
23,Other,Female,Hispanic,Yes,1,46,9,37,41,11,30
23,Other,Female,Other,No,0,64,5,59,101,20,81
23,Other,Female,Other,No,1,50,6,44,42,3,39
23,Other,Female,Other,Yes,0,10,2,8,10,3,7
23,Other,Female,Other,Yes,1,2,0,2,2,0,2
23,Other,Female,White,No,0,129,12,117,173,35,138
23,Other,Female,White,No,1,11,2,9,14,3,11
23,Other,Female,White,Yes,0,32,5,27,48,13,35
23,Other,Female,White,Yes,1,2,0,2,2,1,1
23,Other,Male,Black,No,0,494,38,456,580,96,484
23,Other,Male,Black,No,1,34,4,30,44,4,40
23,Other,Male,Black,Yes,0,182,29,153,198,54,144
23,Other,Male,Black,Yes,1,6,1,5,8,1,7
23,Other,Male,Hispanic,No,0,136,16,120,148,41,107
23,Other,Male,Hispanic,No,1,192,30,162,185,54,131
23,Other,Male,Hispanic,Yes,0,56,15,41,60,25,35
23,Other,Male,Hispanic,Yes,1,113,16,97,103,35,68
23,Other,Male,Other,No,0,48,5,43,86,8,78
23,Other,Male,Other,No,1,48,4,44,37,3,34
23,Other,Male,Other,Yes,0,26,3,23,30,7,23
23,Other,Male,Other,Yes,1,1,1,0,1,0,1
23,Other,Male,White,No,0,162,12,150,196,32,164
23,Other,Male,White,No,1,6,0,6,12,4,8
23,Other,Male,White,Yes,0,92,13,79,99,22,77
23,Other,Male,White,Yes,1,4,1,3,7,2,5
24,Elementary,Female,Black,No,0,4914,933,3981,6238,416,5822
24,Elementary,Female,Black,No,1,699,103,596,1132,48,1084
24,Elementary,Female,Black,Yes,0,908,185,723,1120,109,1011
24,Elementary,Female,Black,Yes,1,30,7,23,28,0,28
24,Elementary,Female,Hispanic,No,0,786,150,636,1014,102,912
24,Elementary,Female,Hispanic,No,1,216,39,177,260,35,225
24,Elementary,Female,Hispanic,Yes,0,150,35,115,224,19,205
24,Elementary,Female,Hispanic,Yes,1,76,22,54,108,12,96
24,Elementary,Female,Other,No,0,1170,246,924,1737,153,1584
24,Elementary,Female,Other,No,1,858,115,743,1145,63,1082
24,Elementary,Female,Other,Yes,0,186,33,153,292,33,259
24,Elementary,Female,Other,Yes,1,27,8,19,56,5,51
24,Elementary,Female,White,No,0,2433,402,2031,3064,244,2820
24,Elementary,Female,White,No,1,261,30,231,372,16,356
24,Elementary,Female,White,Yes,0,663,121,542,791,66,725
24,Elementary,Female,White,Yes,1,15,1,14,16,0,16
24,Elementary,Male,Black,No,0,4512,794,3718,5888,368,5520
24,Elementary,Male,Black,No,1,684,91,593,1043,38,1005
24,Elementary,Male,Black,Yes,0,1917,383,1534,2577,193,2384
24,Elementary,Male,Black,Yes,1,96,15,81,104,18,86
24,Elementary,Male,Hispanic,No,0,750,154,596,990,72,918
24,Elementary,Male,Hispanic,No,1,229,43,186,332,24,308
24,Elementary,Male,Hispanic,Yes,0,270,59,211,412,54,358
24,Elementary,Male,Hispanic,Yes,1,105,23,82,120,19,101
24,Elementary,Male,Other,No,0,1059,183,876,1584,135,1449
24,Elementary,Male,Other,No,1,984,125,859,1358,53,1305
24,Elementary,Male,Other,Yes,0,371,71,300,568,52,516
24,Elementary,Male,Other,Yes,1,63,10,53,76,6,70
24,Elementary,Male,White,No,0,2068,372,1696,2564,256,2308
24,Elementary,Male,White,No,1,294,34,260,440,22,418
24,Elementary,Male,White,Yes,0,1190,223,967,1490,119,1371
24,Elementary,Male,White,Yes,1,30,7,23,44,3,41
24,High,Female,Black,No,0,2302,369,1933,3106,308,2798
24,High,Female,Black,No,1,363,36,327,667,32,635
24,High,Female,Black,Yes,0,468,88,380,644,64,580
24,High,Female,Black,Yes,1,48,8,40,56,3,53
24,High,Female,Hispanic,No,0,381,79,302,522,63,459
24,High,Female,Hispanic,No,1,231,71,160,347,71,276
24,High,Female,Hispanic,Yes,0,57,14,43,60,5,55
24,High,Female,Hispanic,Yes,1,57,10,47,68,5,63
24,High,Female,Other,No,0,220,43,177,308,31,277
24,High,Female,Other,No,1,556,62,494,784,53,731
24,High,Female,Other,Yes,0,33,5,28,44,8,36
24,High,Female,Other,Yes,1,12,0,12,26,2,24
24,High,Female,White,No,0,1118,218,900,1477,129,1348
24,High,Female,White,No,1,123,12,111,175,11,164
24,High,Female,White,Yes,0,312,66,246,345,49,296
24,High,Male,Black,No,0,1991,326,1665,2458,216,2242
24,High,Male,Black,No,1,375,22,353,605,28,577
24,High,Male,Black,Yes,0,799,149,650,1080,126,954
24,High,Male,Black,Yes,1,36,6,30,68,2,66
24,High,Male,Hispanic,No,0,246,52,194,309,32,277
24,High,Male,Hispanic,No,1,260,61,199,340,32,308
24,High,Male,Hispanic,Yes,0,69,15,54,116,18,98
24,High,Male,Hispanic,Yes,1,108,23,85,160,27,133
24,High,Male,Other,No,0,162,22,140,259,20,239
24,High,Male,Other,No,1,576,72,504,760,44,716
24,High,Male,Other,Yes,0,90,22,68,96,3,93
24,High,Male,Other,Yes,1,21,3,18,28,1,27
24,High,Male,White,No,0,879,152,727,1188,93,1095
24,High,Male,White,No,1,159,23,136,216,30,186
24,High,Male,White,Yes,0,348,67,281,407,62,345
24,High,Male,White,Yes,1,3,2,1,4,0,4
24,Middle,Female,Black,No,0,1522,82,1440,2578,72,2506
24,Middle,Female,Black,No,1,234,9,225,468,6,462
24,Middle,Female,Black,Yes,0,282,18,264,428,25,403
24,Middle,Female,Black,Yes,1,21,3,18,44,1,43
24,Middle,Female,Hispanic,No,0,239,16,223,402,38,364
24,Middle,Female,Hispanic,No,1,135,7,128,204,6,198
24,Middle,Female,Hispanic,Yes,0,30,1,29,72,7,65
24,Middle,Female,Hispanic,Yes,1,30,2,28,64,6,58
24,Middle,Female,Other,No,0,198,12,186,284,12,272
24,Middle,Female,Other,No,1,308,7,301,504,7,497
24,Middle,Female,Other,Yes,0,42,5,37,52,7,45
24,Middle,Female,Other,Yes,1,6,0,6,4,0,4
24,Middle,Female,White,No,0,870,35,835,1226,62,1164
24,Middle,Female,White,No,1,90,2,88,148,10,138
24,Middle,Female,White,Yes,0,171,12,159,272,15,257
24,Middle,Female,White,Yes,1,3,0,3,8,0,8
24,Middle,Male,Black,No,0,1344,52,1292,2355,83,2272
24,Middle,Male,Black,No,1,213,4,209,488,7,481
24,Middle,Male,Black,Yes,0,664,40,624,1036,45,991
24,Middle,Male,Black,Yes,1,42,0,42,52,2,50
24,Middle,Male,Hispanic,No,0,191,10,181,388,12,376
24,Middle,Male,Hispanic,No,1,126,9,117,144,7,137
24,Middle,Male,Hispanic,Yes,0,120,8,112,164,11,153
24,Middle,Male,Hispanic,Yes,1,36,2,34,112,5,107
24,Middle,Male,Other,No,0,201,10,191,312,13,299
24,Middle,Male,Other,No,1,342,3,339,488,12,476
24,Middle,Male,Other,Yes,0,60,6,54,72,6,66
24,Middle,Male,Other,Yes,1,33,1,32,60,3,57
24,Middle,Male,White,No,0,885,42,843,1145,72,1073
24,Middle,Male,White,No,1,103,4,99,188,2,186
24,Middle,Male,White,Yes,0,375,31,344,624,54,570
24,Middle,Male,White,Yes,1,9,0,9,4,0,4
24,Other,Female,Black,No,0,1492,240,1252,2356,269,2087
24,Other,Female,Black,No,1,114,14,100,136,18,118
24,Other,Female,Black,Yes,0,178,31,147,381,58,323
24,Other,Female,Black,Yes,1,6,1,5,8,0,8
24,Other,Female,Hispanic,No,0,443,89,354,712,68,644
24,Other,Female,Hispanic,No,1,538,157,381,751,75,676
24,Other,Female,Hispanic,Yes,0,52,12,40,88,10,78
24,Other,Female,Hispanic,Yes,1,138,28,110,164,20,144
24,Other,Female,Other,No,0,193,37,156,408,32,376
24,Other,Female,Other,No,1,153,10,143,168,6,162
24,Other,Female,Other,Yes,0,28,4,24,40,2,38
24,Other,Female,Other,Yes,1,6,0,6,8,1,7
24,Other,Female,White,No,0,382,68,314,695,92,603
24,Other,Female,White,No,1,33,3,30,57,3,54
24,Other,Female,White,Yes,0,99,19,80,192,34,158
24,Other,Female,White,Yes,1,6,1,5,8,3,5
24,Other,Male,Black,No,0,1467,183,1284,2330,240,2090
24,Other,Male,Black,No,1,98,12,86,184,13,171
24,Other,Male,Black,Yes,0,540,94,446,794,104,690
24,Other,Male,Black,Yes,1,18,4,14,32,2,30
24,Other,Male,Hispanic,No,0,401,92,309,603,69,534
24,Other,Male,Hispanic,No,1,577,123,454,742,92,650
24,Other,Male,Hispanic,Yes,0,166,39,127,240,52,188
24,Other,Male,Hispanic,Yes,1,333,69,264,412,58,354
24,Other,Male,Other,No,0,147,28,119,344,15,329
24,Other,Male,Other,No,1,144,7,137,148,6,142
24,Other,Male,Other,Yes,0,78,16,62,120,12,108
24,Other,Male,Other,Yes,1,3,0,3,4,0,4
24,Other,Male,White,No,0,482,77,405,788,88,700
24,Other,Male,White,No,1,18,4,14,48,8,40
24,Other,Male,White,Yes,0,272,51,221,397,63,334
24,Other,Male,White,Yes,1,12,1,11,28,8,20
25,Elementary,Female,Black,No,0,8192,756,7436,7764,715,7049
25,Elementary,Female,Black,No,1,1168,65,1103,1419,71,1348
25,Elementary,Female,Black,Yes,0,1514,154,1360,1404,141,1263
25,Elementary,Female,Black,Yes,1,50,6,44,35,2,33
25,Elementary,Female,Hispanic,No,0,1306,134,1172,1263,144,1119
25,Elementary,Female,Hispanic,No,1,360,46,314,321,47,274
25,Elementary,Female,Hispanic,Yes,0,250,31,219,280,39,241
25,Elementary,Female,Hispanic,Yes,1,132,24,108,134,21,113
25,Elementary,Female,Other,No,0,1942,223,1719,2175,239,1936
25,Elementary,Female,Other,No,1,1430,80,1350,1430,74,1356
25,Elementary,Female,Other,Yes,0,314,36,278,365,33,332
25,Elementary,Female,Other,Yes,1,45,7,38,70,1,69
25,Elementary,Female,White,No,0,4049,402,3647,3836,365,3471
25,Elementary,Female,White,No,1,436,28,408,465,28,437
25,Elementary,Female,White,Yes,0,1111,103,1008,987,116,871
25,Elementary,Female,White,Yes,1,25,1,24,20,0,20
25,Elementary,Male,Black,No,0,7507,692,6815,7367,681,6686
25,Elementary,Male,Black,No,1,1143,54,1089,1307,49,1258
25,Elementary,Male,Black,Yes,0,3194,348,2846,3216,309,2907
25,Elementary,Male,Black,Yes,1,160,2,158,130,19,111
25,Elementary,Male,Hispanic,No,0,1241,129,1112,1237,133,1104
25,Elementary,Male,Hispanic,No,1,385,50,335,415,39,376
25,Elementary,Male,Hispanic,Yes,0,450,56,394,516,73,443
25,Elementary,Male,Hispanic,Yes,1,176,34,142,150,23,127
25,Elementary,Male,Other,No,0,1764,181,1583,1967,205,1762
25,Elementary,Male,Other,No,1,1640,86,1554,1695,84,1611
25,Elementary,Male,Other,Yes,0,618,64,554,710,72,638
25,Elementary,Male,Other,Yes,1,105,7,98,95,11,84
25,Elementary,Male,White,No,0,3445,331,3114,3216,323,2893
25,Elementary,Male,White,No,1,491,31,460,550,38,512
25,Elementary,Male,White,Yes,0,1983,230,1753,1873,173,1700
25,Elementary,Male,White,Yes,1,50,3,47,55,4,51
25,High,Female,Black,No,0,3819,293,3526,3869,372,3497
25,High,Female,Black,No,1,605,31,574,835,28,807
25,High,Female,Black,Yes,0,783,76,707,799,109,690
25,High,Female,Black,Yes,1,80,4,76,70,1,69
25,High,Female,Hispanic,No,0,635,71,564,645,77,568
25,High,Female,Hispanic,No,1,382,69,313,435,101,334
25,High,Female,Hispanic,Yes,0,95,10,85,75,7,68
25,High,Female,Hispanic,Yes,1,95,17,78,85,6,79
25,High,Female,Other,No,0,370,42,328,385,36,349
25,High,Female,Other,No,1,925,72,853,980,74,906
25,High,Female,Other,Yes,0,55,7,48,55,13,42
25,High,Female,Other,Yes,1,20,1,19,33,5,28
25,High,Female,White,No,0,1865,193,1672,1845,164,1681
25,High,Female,White,No,1,205,13,192,215,15,200
25,High,Female,White,Yes,0,511,65,446,428,65,363
25,High,Male,Black,No,0,3317,281,3036,3077,282,2795
25,High,Male,Black,No,1,623,21,602,760,34,726
25,High,Male,Black,Yes,0,1338,131,1207,1340,169,1171
25,High,Male,Black,Yes,1,60,1,59,85,3,82
25,High,Male,Hispanic,No,0,411,55,356,391,28,363
25,High,Male,Hispanic,No,1,435,64,371,423,50,373
25,High,Male,Hispanic,Yes,0,115,13,102,145,29,116
25,High,Male,Hispanic,Yes,1,177,36,141,200,29,171
25,High,Male,Other,No,0,270,15,255,320,25,295
25,High,Male,Other,No,1,956,67,889,947,75,872
25,High,Male,Other,Yes,0,150,11,139,120,10,110
25,High,Male,Other,Yes,1,35,0,35,35,2,33
25,High,Male,White,No,0,1464,123,1341,1488,121,1367
25,High,Male,White,No,1,270,22,248,270,43,227
25,High,Male,White,Yes,0,580,83,497,510,80,430
25,High,Male,White,Yes,1,5,1,4,5,0,5
25,Middle,Female,Black,No,0,2542,36,2506,3237,110,3127
25,Middle,Female,Black,No,1,390,9,381,586,3,583
25,Middle,Female,Black,Yes,0,470,12,458,535,23,512
25,Middle,Female,Black,Yes,1,35,0,35,55,0,55
25,Middle,Female,Hispanic,No,0,400,12,388,513,19,494
25,Middle,Female,Hispanic,No,1,228,6,222,255,5,250
25,Middle,Female,Hispanic,Yes,0,50,1,49,86,8,78
25,Middle,Female,Hispanic,Yes,1,50,0,50,80,8,72
25,Middle,Female,Other,No,0,330,7,323,355,22,333
25,Middle,Female,Other,No,1,510,6,504,628,16,612
25,Middle,Female,Other,Yes,0,70,3,67,65,16,49
25,Middle,Female,Other,Yes,1,10,0,10,5,0,5
25,Middle,Female,White,No,0,1450,38,1412,1530,80,1450
25,Middle,Female,White,No,1,150,2,148,185,2,183
25,Middle,Female,White,Yes,0,284,7,277,340,12,328
25,Middle,Female,White,Yes,1,5,0,5,10,1,9
25,Middle,Male,Black,No,0,2237,25,2212,2944,124,2820
25,Middle,Male,Black,No,1,355,3,352,609,5,604
25,Middle,Male,Black,Yes,0,1109,27,1082,1299,70,1229
25,Middle,Male,Black,Yes,1,70,0,70,65,1,64
25,Middle,Male,Hispanic,No,0,320,11,309,493,27,466
25,Middle,Male,Hispanic,No,1,210,8,202,180,3,177
25,Middle,Male,Hispanic,Yes,0,196,6,190,205,10,195
25,Middle,Male,Hispanic,Yes,1,60,3,57,140,11,129
25,Middle,Male,Other,No,0,335,7,328,389,26,363
25,Middle,Male,Other,No,1,574,2,572,607,11,596
25,Middle,Male,Other,Yes,0,100,6,94,90,11,79
25,Middle,Male,Other,Yes,1,55,0,55,75,4,71
25,Middle,Male,White,No,0,1469,36,1433,1418,92,1326
25,Middle,Male,White,No,1,170,3,167,235,8,227
25,Middle,Male,White,Yes,0,620,26,594,780,53,727
25,Middle,Male,White,Yes,1,15,0,15,5,0,5
25,Other,Female,Black,No,0,2537,263,2274,2982,379,2603
25,Other,Female,Black,No,1,190,11,179,170,21,149
25,Other,Female,Black,Yes,0,314,44,270,483,84,399
25,Other,Female,Black,Yes,1,10,0,10,10,0,10
25,Other,Female,Hispanic,No,0,756,99,657,891,127,764
25,Other,Female,Hispanic,No,1,900,130,770,936,139,797
25,Other,Female,Hispanic,Yes,0,90,16,74,110,15,95
25,Other,Female,Hispanic,Yes,1,230,32,198,205,35,170
25,Other,Female,Other,No,0,325,37,288,518,45,473
25,Other,Female,Other,No,1,255,13,242,210,12,198
25,Other,Female,Other,Yes,0,45,5,40,50,3,47
25,Other,Female,Other,Yes,1,10,0,10,10,0,10
25,Other,Female,White,No,0,639,74,565,875,135,740
25,Other,Female,White,No,1,55,1,54,75,6,69
25,Other,Female,White,Yes,0,160,20,140,240,38,202
25,Other,Female,White,Yes,1,10,2,8,10,3,7
25,Other,Male,Black,No,0,2500,239,2261,2942,346,2596
25,Other,Male,Black,No,1,162,10,152,230,22,208
25,Other,Male,Black,Yes,0,912,119,793,1003,158,845
25,Other,Male,Black,Yes,1,30,4,26,40,3,37
25,Other,Male,Hispanic,No,0,674,91,583,756,107,649
25,Other,Male,Hispanic,No,1,965,154,811,936,161,775
25,Other,Male,Hispanic,Yes,0,280,47,233,309,65,244
25,Other,Male,Hispanic,Yes,1,565,75,490,511,81,430
25,Other,Male,Other,No,0,243,32,211,431,43,388
25,Other,Male,Other,No,1,244,15,229,185,15,170
25,Other,Male,Other,Yes,0,135,14,121,152,23,129
25,Other,Male,Other,Yes,1,5,3,2,5,0,5
25,Other,Male,White,No,0,815,79,736,999,124,875
25,Other,Male,White,No,1,30,5,25,60,15,45
25,Other,Male,White,Yes,0,446,74,372,494,79,415
25,Other,Male,White,Yes,1,20,2,18,35,7,28
26,Elementary,Female,Black,No,0,8174,790,7384,7759,630,7129
26,Elementary,Female,Black,No,1,1179,77,1102,1429,67,1362
26,Elementary,Female,Black,Yes,0,1510,154,1356,1396,121,1275
26,Elementary,Female,Black,Yes,1,50,7,43,35,0,35
26,Elementary,Female,Hispanic,No,0,1302,172,1130,1273,124,1149
26,Elementary,Female,Hispanic,No,1,360,51,309,317,20,297
26,Elementary,Female,Hispanic,Yes,0,250,29,221,280,47,233
26,Elementary,Female,Hispanic,Yes,1,135,30,105,130,11,119
26,Elementary,Female,Other,No,0,1936,249,1687,2174,212,1962
26,Elementary,Female,Other,No,1,1440,106,1334,1432,97,1335
26,Elementary,Female,Other,Yes,0,311,44,267,365,49,316
26,Elementary,Female,Other,Yes,1,45,8,37,70,8,62
26,Elementary,Female,White,No,0,4052,413,3639,3817,351,3466
26,Elementary,Female,White,No,1,450,35,415,465,27,438
26,Elementary,Female,White,Yes,0,1111,104,1007,985,92,893
26,Elementary,Female,White,Yes,1,25,3,22,20,0,20
26,Elementary,Male,Black,No,0,7488,712,6776,7388,625,6763
26,Elementary,Male,Black,No,1,1154,70,1084,1324,51,1273
26,Elementary,Male,Black,Yes,0,3190,337,2853,3219,330,2889
26,Elementary,Male,Black,Yes,1,160,10,150,130,17,113
26,Elementary,Male,Hispanic,No,0,1248,146,1102,1242,159,1083
26,Elementary,Male,Hispanic,No,1,385,55,330,415,38,377
26,Elementary,Male,Hispanic,Yes,0,450,68,382,525,93,432
26,Elementary,Male,Hispanic,Yes,1,180,40,140,150,27,123
26,Elementary,Male,Other,No,0,1760,205,1555,1967,192,1775
26,Elementary,Male,Other,No,1,1646,89,1557,1695,95,1600
26,Elementary,Male,Other,Yes,0,615,79,536,714,84,630
26,Elementary,Male,Other,Yes,1,105,14,91,95,8,87
26,Elementary,Male,White,No,0,3436,342,3094,3193,294,2899
26,Elementary,Male,White,No,1,498,45,453,550,37,513
26,Elementary,Male,White,Yes,0,1987,243,1744,1878,221,1657
26,Elementary,Male,White,Yes,1,50,5,45,55,8,47
26,High,Female,Black,No,0,3813,284,3529,3883,352,3531
26,High,Female,Black,No,1,605,32,573,845,22,823
26,High,Female,Black,Yes,0,776,75,701,798,106,692
26,High,Female,Black,Yes,1,80,4,76,70,3,67
26,High,Female,Hispanic,No,0,631,58,573,642,80,562
26,High,Female,Hispanic,No,1,380,53,327,435,92,343
26,High,Female,Hispanic,Yes,0,95,4,91,75,8,67
26,High,Female,Hispanic,Yes,1,95,6,89,85,16,69
26,High,Female,Other,No,0,372,31,341,385,45,340
26,High,Female,Other,No,1,925,61,864,981,73,908
26,High,Female,Other,Yes,0,55,0,55,55,12,43
26,High,Female,Other,Yes,1,20,2,18,32,6,26
26,High,Female,White,No,0,1862,200,1662,1852,160,1692
26,High,Female,White,No,1,205,18,187,215,14,201
26,High,Female,White,Yes,0,501,67,434,422,63,359
26,High,Male,Black,No,0,3291,246,3045,3083,268,2815
26,High,Male,Black,No,1,620,23,597,757,26,731
26,High,Male,Black,Yes,0,1343,124,1219,1324,149,1175
26,High,Male,Black,Yes,1,60,1,59,85,2,83
26,High,Male,Hispanic,No,0,415,66,349,393,34,359
26,High,Male,Hispanic,No,1,434,51,383,418,46,372
26,High,Male,Hispanic,Yes,0,115,12,103,150,27,123
26,High,Male,Hispanic,Yes,1,178,29,149,200,28,172
26,High,Male,Other,No,0,267,17,250,320,18,302
26,High,Male,Other,No,1,948,51,897,945,80,865
26,High,Male,Other,Yes,0,150,15,135,120,11,109
26,High,Male,Other,Yes,1,35,0,35,35,4,31
26,High,Male,White,No,0,1453,108,1345,1481,90,1391
26,High,Male,White,No,1,270,27,243,265,30,235
26,High,Male,White,Yes,0,582,97,485,510,61,449
26,High,Male,White,Yes,1,5,0,5,5,0,5
26,Middle,Female,Black,No,0,2544,70,2474,3248,123,3125
26,Middle,Female,Black,No,1,390,10,380,595,4,591
26,Middle,Female,Black,Yes,0,470,13,457,535,30,505
26,Middle,Female,Black,Yes,1,39,1,38,55,2,53
26,Middle,Female,Hispanic,No,0,400,20,380,505,23,482
26,Middle,Female,Hispanic,No,1,234,17,217,255,7,248
26,Middle,Female,Hispanic,Yes,0,50,0,50,85,3,82
26,Middle,Female,Hispanic,Yes,1,50,0,50,80,11,69
26,Middle,Female,Other,No,0,330,2,328,355,24,331
26,Middle,Female,Other,No,1,512,8,504,623,7,616
26,Middle,Female,Other,Yes,0,70,8,62,65,11,54
26,Middle,Female,Other,Yes,1,10,0,10,5,0,5
26,Middle,Female,White,No,0,1450,54,1396,1530,57,1473
26,Middle,Female,White,No,1,150,3,147,185,5,180
26,Middle,Female,White,Yes,0,280,9,271,340,14,326
26,Middle,Female,White,Yes,1,5,0,5,10,0,10
26,Middle,Male,Black,No,0,2232,42,2190,2965,88,2877
26,Middle,Male,Black,No,1,355,3,352,618,14,604
26,Middle,Male,Black,Yes,0,1110,35,1075,1293,67,1226
26,Middle,Male,Black,Yes,1,70,0,70,65,2,63
26,Middle,Male,Hispanic,No,0,320,8,312,495,28,467
26,Middle,Male,Hispanic,No,1,210,12,198,180,5,175
26,Middle,Male,Hispanic,Yes,0,195,8,187,205,15,190
26,Middle,Male,Hispanic,Yes,1,60,3,57,140,8,132
26,Middle,Male,Other,No,0,335,12,323,390,18,372
26,Middle,Male,Other,No,1,577,4,573,605,9,596
26,Middle,Male,Other,Yes,0,100,1,99,90,10,80
26,Middle,Male,Other,Yes,1,55,0,55,75,7,68
26,Middle,Male,White,No,0,1467,42,1425,1407,75,1332
26,Middle,Male,White,No,1,170,8,162,235,4,231
26,Middle,Male,White,Yes,0,622,30,592,774,56,718
26,Middle,Male,White,Yes,1,15,0,15,5,0,5
26,Other,Female,Black,No,0,2527,310,2217,2991,359,2632
26,Other,Female,Black,No,1,190,14,176,170,19,151
26,Other,Female,Black,Yes,0,324,57,267,481,70,411
26,Other,Female,Black,Yes,1,10,0,10,10,0,10
26,Other,Female,Hispanic,No,0,765,102,663,890,116,774
26,Other,Female,Hispanic,No,1,901,129,772,935,106,829
26,Other,Female,Hispanic,Yes,0,88,14,74,112,15,97
26,Other,Female,Hispanic,Yes,1,230,31,199,205,25,180
26,Other,Female,Other,No,0,325,40,285,524,48,476
26,Other,Female,Other,No,1,255,12,243,208,9,199
26,Other,Female,Other,Yes,0,45,9,36,50,1,49
26,Other,Female,Other,Yes,1,10,0,10,10,0,10
26,Other,Female,White,No,0,631,83,548,873,132,741
26,Other,Female,White,No,1,55,1,54,75,9,66
26,Other,Female,White,Yes,0,164,24,140,244,37,207
26,Other,Female,White,Yes,1,10,4,6,10,3,7
26,Other,Male,Black,No,0,2510,233,2277,2950,347,2603
26,Other,Male,Black,No,1,170,14,156,232,15,217
26,Other,Male,Black,Yes,0,921,142,779,1012,138,874
26,Other,Male,Black,Yes,1,30,8,22,40,4,36
26,Other,Male,Hispanic,No,0,680,102,578,746,115,631
26,Other,Male,Hispanic,No,1,968,172,796,930,122,808
26,Other,Male,Hispanic,Yes,0,280,41,239,309,73,236
26,Other,Male,Hispanic,Yes,1,566,69,497,510,81,429
26,Other,Male,Other,No,0,245,36,209,430,44,386
26,Other,Male,Other,No,1,245,9,236,185,5,180
26,Other,Male,Other,Yes,0,140,27,113,155,19,136
26,Other,Male,Other,Yes,1,5,1,4,5,0,5
26,Other,Male,White,No,0,815,82,733,998,124,874
26,Other,Male,White,No,1,30,5,25,60,12,48
26,Other,Male,White,Yes,0,443,64,379,490,76,414
26,Other,Male,White,Yes,1,20,3,17,35,6,29
27,Elementary,Female,Black,No,0,8151,1084,7067,7768,710,7058
27,Elementary,Female,Black,No,1,1185,87,1098,1440,79,1361
27,Elementary,Female,Black,Yes,0,1513,224,1289,1400,120,1280
27,Elementary,Female,Black,Yes,1,50,7,43,35,3,32
27,Elementary,Female,Hispanic,No,0,1302,204,1098,1279,141,1138
27,Elementary,Female,Hispanic,No,1,356,52,304,316,36,280
27,Elementary,Female,Hispanic,Yes,0,250,30,220,280,48,232
27,Elementary,Female,Hispanic,Yes,1,135,33,102,130,27,103
27,Elementary,Female,Other,No,0,1920,341,1579,2174,205,1969
27,Elementary,Female,Other,No,1,1440,123,1317,1437,105,1332
27,Elementary,Female,Other,Yes,0,310,50,260,367,49,318
27,Elementary,Female,Other,Yes,1,45,6,39,70,6,64
27,Elementary,Female,White,No,0,4065,497,3568,3810,391,3419
27,Elementary,Female,White,No,1,452,50,402,465,29,436
27,Elementary,Female,White,Yes,0,1105,144,961,982,98,884
27,Elementary,Female,White,Yes,1,25,0,25,20,2,18
27,Elementary,Male,Black,No,0,7475,1033,6442,7398,703,6695
27,Elementary,Male,Black,No,1,1158,86,1072,1330,58,1272
27,Elementary,Male,Black,Yes,0,3188,452,2736,3225,347,2878
27,Elementary,Male,Black,Yes,1,160,16,144,130,15,115
27,Elementary,Male,Hispanic,No,0,1253,210,1043,1245,156,1089
27,Elementary,Male,Hispanic,No,1,385,68,317,415,48,367
27,Elementary,Male,Hispanic,Yes,0,447,93,354,525,81,444
27,Elementary,Male,Hispanic,Yes,1,180,33,147,150,24,126
27,Elementary,Male,Other,No,0,1758,266,1492,1972,230,1742
27,Elementary,Male,Other,No,1,1654,115,1539,1695,104,1591
27,Elementary,Male,Other,Yes,0,615,106,509,715,104,611
27,Elementary,Male,Other,Yes,1,105,9,96,95,18,77
27,Elementary,Male,White,No,0,3425,477,2948,3195,329,2866
27,Elementary,Male,White,No,1,510,76,434,550,43,507
27,Elementary,Male,White,Yes,0,1996,288,1708,1879,213,1666
27,Elementary,Male,White,Yes,1,50,7,43,55,2,53
27,High,Female,Black,No,0,3810,427,3383,3880,439,3441
27,High,Female,Black,No,1,602,37,565,859,32,827
27,High,Female,Black,Yes,0,775,81,694,795,104,691
27,High,Female,Black,Yes,1,80,6,74,70,2,68
27,High,Female,Hispanic,No,0,628,107,521,640,98,542
27,High,Female,Hispanic,No,1,378,68,310,438,88,350
27,High,Female,Hispanic,Yes,0,95,8,87,75,10,65
27,High,Female,Hispanic,Yes,1,95,12,83,85,8,77
27,High,Female,Other,No,0,370,55,315,385,38,347
27,High,Female,Other,No,1,924,67,857,980,86,894
27,High,Female,Other,Yes,0,55,5,50,55,10,45
27,High,Female,Other,Yes,1,20,5,15,34,4,30
27,High,Female,White,No,0,1848,248,1600,1855,194,1661
27,High,Female,White,No,1,202,12,190,215,19,196
27,High,Female,White,Yes,0,495,79,416,417,71,346
27,High,Male,Black,No,0,3272,360,2912,3082,285,2797
27,High,Male,Black,No,1,619,31,588,760,27,733
27,High,Male,Black,Yes,0,1336,162,1174,1318,155,1163
27,High,Male,Black,Yes,1,60,3,57,85,4,81
27,High,Male,Hispanic,No,0,415,73,342,390,33,357
27,High,Male,Hispanic,No,1,428,73,355,410,51,359
27,High,Male,Hispanic,Yes,0,115,16,99,150,27,123
27,High,Male,Hispanic,Yes,1,179,42,137,200,30,170
27,High,Male,Other,No,0,265,27,238,320,14,306
27,High,Male,Other,No,1,943,77,866,945,69,876
27,High,Male,Other,Yes,0,150,20,130,120,8,112
27,High,Male,Other,Yes,1,35,2,33,35,4,31
27,High,Male,White,No,0,1451,167,1284,1485,95,1390
27,High,Male,White,No,1,269,37,232,260,24,236
27,High,Male,White,Yes,0,582,113,469,505,61,444
27,High,Male,White,Yes,1,5,0,5,5,0,5
27,Middle,Female,Black,No,0,2545,96,2449,3250,150,3100
27,Middle,Female,Black,No,1,390,8,382,605,7,598
27,Middle,Female,Black,Yes,0,470,24,446,535,25,510
27,Middle,Female,Black,Yes,1,40,0,40,55,0,55
27,Middle,Female,Hispanic,No,0,400,36,364,500,34,466
27,Middle,Female,Hispanic,No,1,235,17,218,255,13,242
27,Middle,Female,Hispanic,Yes,0,50,2,48,85,4,81
27,Middle,Female,Hispanic,Yes,1,50,4,46,80,13,67
27,Middle,Female,Other,No,0,330,6,324,355,32,323
27,Middle,Female,Other,No,1,515,8,507,620,18,602
27,Middle,Female,Other,Yes,0,70,5,65,65,12,53
27,Middle,Female,Other,Yes,1,10,0,10,5,1,4
27,Middle,Female,White,No,0,1447,63,1384,1533,85,1448
27,Middle,Female,White,No,1,150,7,143,185,2,183
27,Middle,Female,White,Yes,0,283,11,272,340,27,313
27,Middle,Female,White,Yes,1,5,0,5,10,1,9
27,Middle,Male,Black,No,0,2230,89,2141,2957,112,2845
27,Middle,Male,Black,No,1,355,4,351,624,13,611
27,Middle,Male,Black,Yes,0,1115,51,1064,1298,70,1228
27,Middle,Male,Black,Yes,1,70,0,70,65,2,63
27,Middle,Male,Hispanic,No,0,320,15,305,495,27,468
27,Middle,Male,Hispanic,No,1,210,11,199,180,11,169
27,Middle,Male,Hispanic,Yes,0,192,11,181,205,21,184
27,Middle,Male,Hispanic,Yes,1,60,3,57,140,12,128
27,Middle,Male,Other,No,0,338,17,321,390,29,361
27,Middle,Male,Other,No,1,580,14,566,605,9,596
27,Middle,Male,Other,Yes,0,100,10,90,86,7,79
27,Middle,Male,Other,Yes,1,55,1,54,75,6,69
27,Middle,Male,White,No,0,1476,61,1415,1412,97,1315
27,Middle,Male,White,No,1,173,5,168,235,10,225
27,Middle,Male,White,Yes,0,621,52,569,775,84,691
27,Middle,Male,White,Yes,1,15,1,14,5,0,5
27,Other,Female,Black,No,0,2535,341,2194,2986,378,2608
27,Other,Female,Black,No,1,190,11,179,170,21,149
27,Other,Female,Black,Yes,0,328,62,266,475,92,383
27,Other,Female,Black,Yes,1,10,2,8,10,2,8
27,Other,Female,Hispanic,No,0,763,140,623,887,131,756
27,Other,Female,Hispanic,No,1,902,155,747,935,97,838
27,Other,Female,Hispanic,Yes,0,84,17,67,117,13,104
27,Other,Female,Hispanic,Yes,1,230,43,187,205,24,181
27,Other,Female,Other,No,0,325,47,278,523,32,491
27,Other,Female,Other,No,1,255,21,234,209,10,199
27,Other,Female,Other,Yes,0,45,9,36,50,9,41
27,Other,Female,Other,Yes,1,10,0,10,10,0,10
27,Other,Female,White,No,0,629,92,537,870,142,728
27,Other,Female,White,No,1,55,1,54,75,6,69
27,Other,Female,White,Yes,0,165,27,138,243,45,198
27,Other,Female,White,Yes,1,10,2,8,10,4,6
27,Other,Male,Black,No,0,2527,277,2250,2934,391,2543
27,Other,Male,Black,No,1,169,15,154,235,20,215
27,Other,Male,Black,Yes,0,926,155,771,1006,166,840
27,Other,Male,Black,Yes,1,30,4,26,41,3,38
27,Other,Male,Hispanic,No,0,682,123,559,744,99,645
27,Other,Male,Hispanic,No,1,968,189,779,930,107,823
27,Other,Male,Hispanic,Yes,0,283,48,235,306,61,245
27,Other,Male,Hispanic,Yes,1,570,94,476,510,81,429
27,Other,Male,Other,No,0,245,31,214,426,47,379
27,Other,Male,Other,No,1,250,16,234,185,13,172
27,Other,Male,Other,Yes,0,140,27,113,159,31,128
27,Other,Male,Other,Yes,1,5,2,3,5,0,5
27,Other,Male,White,No,0,812,99,713,996,102,894
27,Other,Male,White,No,1,30,7,23,60,14,46
27,Other,Male,White,Yes,0,445,75,370,485,77,408
27,Other,Male,White,Yes,1,20,1,19,35,8,27
28,Elementary,Female,Black,No,0,8153,808,7345,7763,679,7084
28,Elementary,Female,Black,No,1,1185,83,1102,1442,62,1380
28,Elementary,Female,Black,Yes,0,1520,135,1385,1400,163,1237
28,Elementary,Female,Black,Yes,1,50,8,42,35,0,35
28,Elementary,Female,Hispanic,No,0,1302,148,1154,1271,148,1123
28,Elementary,Female,Hispanic,No,1,355,40,315,320,31,289
28,Elementary,Female,Hispanic,Yes,0,250,26,224,280,47,233
28,Elementary,Female,Hispanic,Yes,1,135,17,118,130,24,106
28,Elementary,Female,Other,No,0,1915,236,1679,2179,187,1992
28,Elementary,Female,Other,No,1,1440,91,1349,1436,86,1350
28,Elementary,Female,Other,Yes,0,308,41,267,370,45,325
28,Elementary,Female,Other,Yes,1,45,3,42,70,5,65
28,Elementary,Female,White,No,0,4068,374,3694,3800,349,3451
28,Elementary,Female,White,No,1,452,43,409,465,34,431
28,Elementary,Female,White,Yes,0,1101,119,982,985,103,882
28,Elementary,Female,White,Yes,1,25,0,25,20,1,19
28,Elementary,Male,Black,No,0,7474,648,6826,7375,643,6732
28,Elementary,Male,Black,No,1,1151,77,1074,1332,63,1269
28,Elementary,Male,Black,Yes,0,3190,353,2837,3219,328,2891
28,Elementary,Male,Black,Yes,1,160,14,146,130,22,108
28,Elementary,Male,Hispanic,No,0,1257,138,1119,1242,132,1110
28,Elementary,Male,Hispanic,No,1,385,54,331,415,39,376
28,Elementary,Male,Hispanic,Yes,0,445,47,398,526,90,436
28,Elementary,Male,Hispanic,Yes,1,180,28,152,147,28,119
28,Elementary,Male,Other,No,0,1749,171,1578,1977,190,1787
28,Elementary,Male,Other,No,1,1660,102,1558,1695,103,1592
28,Elementary,Male,Other,Yes,0,615,72,543,715,81,634
28,Elementary,Male,Other,Yes,1,105,15,90,95,15,80
28,Elementary,Male,White,No,0,3425,323,3102,3197,305,2892
28,Elementary,Male,White,No,1,508,34,474,550,56,494
28,Elementary,Male,White,Yes,0,1997,215,1782,1878,190,1688
28,Elementary,Male,White,Yes,1,50,6,44,55,3,52
28,High,Female,Black,No,0,3819,275,3544,3874,384,3490
28,High,Female,Black,No,1,604,36,568,860,29,831
28,High,Female,Black,Yes,0,781,60,721,795,125,670
28,High,Female,Black,Yes,1,80,6,74,70,5,65
28,High,Female,Hispanic,No,0,628,65,563,637,94,543
28,High,Female,Hispanic,No,1,380,53,327,435,84,351
28,High,Female,Hispanic,Yes,0,95,6,89,75,7,68
28,High,Female,Hispanic,Yes,1,95,7,88,85,11,74
28,High,Female,Other,No,0,370,39,331,385,33,352
28,High,Female,Other,No,1,925,57,868,980,76,904
28,High,Female,Other,Yes,0,55,6,49,55,10,45
28,High,Female,Other,Yes,1,20,3,17,35,4,31
28,High,Female,White,No,0,1845,201,1644,1852,182,1670
28,High,Female,White,No,1,200,17,183,215,25,190
28,High,Female,White,Yes,0,495,46,449,420,59,361
28,High,Male,Black,No,0,3259,228,3031,3079,256,2823
28,High,Male,Black,No,1,623,17,606,757,23,734
28,High,Male,Black,Yes,0,1335,132,1203,1325,155,1170
28,High,Male,Black,Yes,1,60,2,58,85,3,82
28,High,Male,Hispanic,No,0,417,46,371,393,23,370
28,High,Male,Hispanic,No,1,430,59,371,410,39,371
28,High,Male,Hispanic,Yes,0,115,16,99,150,34,116
28,High,Male,Hispanic,Yes,1,175,35,140,200,31,169
28,High,Male,Other,No,0,265,12,253,320,21,299
28,High,Male,Other,No,1,945,62,883,945,69,876
28,High,Male,Other,Yes,0,150,18,132,121,9,112
28,High,Male,Other,Yes,1,35,1,34,35,2,33
28,High,Male,White,No,0,1467,119,1348,1485,84,1401
28,High,Male,White,No,1,270,26,244,260,29,231
28,High,Male,White,Yes,0,577,88,489,500,64,436
28,High,Male,White,Yes,1,5,0,5,5,0,5
28,Middle,Female,Black,No,0,2547,36,2511,3257,125,3132
28,Middle,Female,Black,No,1,390,10,380,606,7,599
28,Middle,Female,Black,Yes,0,470,6,464,536,31,505
28,Middle,Female,Black,Yes,1,40,1,39,55,3,52
28,Middle,Female,Hispanic,No,0,400,14,386,497,28,469
28,Middle,Female,Hispanic,No,1,235,7,228,259,9,250
28,Middle,Female,Hispanic,Yes,0,50,0,50,85,7,78
28,Middle,Female,Hispanic,Yes,1,50,0,50,80,10,70
28,Middle,Female,Other,No,0,324,13,311,357,15,342
28,Middle,Female,Other,No,1,515,6,509,620,11,609
28,Middle,Female,Other,Yes,0,70,3,67,65,11,54
28,Middle,Female,Other,Yes,1,10,1,9,5,0,5
28,Middle,Female,White,No,0,1445,45,1400,1535,78,1457
28,Middle,Female,White,No,1,150,1,149,185,0,185
28,Middle,Female,White,Yes,0,286,8,278,340,31,309
28,Middle,Female,White,Yes,1,5,0,5,10,0,10
28,Middle,Male,Black,No,0,2227,51,2176,2951,122,2829
28,Middle,Male,Black,No,1,360,13,347,625,9,616
28,Middle,Male,Black,Yes,0,1115,29,1086,1295,76,1219
28,Middle,Male,Black,Yes,1,70,2,68,65,1,64
28,Middle,Male,Hispanic,No,0,320,12,308,499,24,475
28,Middle,Male,Hispanic,No,1,210,8,202,182,8,174
28,Middle,Male,Hispanic,Yes,0,190,9,181,205,15,190
28,Middle,Male,Hispanic,Yes,1,60,2,58,140,16,124
28,Middle,Male,Other,No,0,337,16,321,392,33,359
28,Middle,Male,Other,No,1,580,5,575,605,13,592
28,Middle,Male,Other,Yes,0,100,5,95,85,8,77
28,Middle,Male,Other,Yes,1,55,1,54,75,3,72
28,Middle,Male,White,No,0,1480,41,1439,1420,66,1354
28,Middle,Male,White,No,1,175,3,172,235,8,227
28,Middle,Male,White,Yes,0,625,23,602,775,73,702
28,Middle,Male,White,Yes,1,15,0,15,5,0,5
28,Other,Female,Black,No,0,2532,248,2284,2985,377,2608
28,Other,Female,Black,No,1,190,9,181,175,20,155
28,Other,Female,Black,Yes,0,335,48,287,479,87,392
28,Other,Female,Black,Yes,1,10,1,9,10,0,10
28,Other,Female,Hispanic,No,0,760,96,664,874,118,756
28,Other,Female,Hispanic,No,1,905,163,742,937,121,816
28,Other,Female,Hispanic,Yes,0,80,10,70,120,15,105
28,Other,Female,Hispanic,Yes,1,230,31,199,205,25,180
28,Other,Female,Other,No,0,325,37,288,523,53,470
28,Other,Female,Other,No,1,255,20,235,210,6,204
28,Other,Female,Other,Yes,0,44,7,37,50,6,44
28,Other,Female,Other,Yes,1,10,1,9,10,0,10
28,Other,Female,White,No,0,627,72,555,873,134,739
28,Other,Female,White,No,1,55,2,53,77,5,72
28,Other,Female,White,Yes,0,165,24,141,240,54,186
28,Other,Female,White,Yes,1,10,4,6,10,4,6
28,Other,Male,Black,No,0,2535,211,2324,2921,339,2582
28,Other,Male,Black,No,1,165,13,152,240,15,225
28,Other,Male,Black,Yes,0,914,104,810,999,136,863
28,Other,Male,Black,Yes,1,30,4,26,45,3,42
28,Other,Male,Hispanic,No,0,681,104,577,744,116,628
28,Other,Male,Hispanic,No,1,962,182,780,922,116,806
28,Other,Male,Hispanic,Yes,0,285,49,236,310,69,241
28,Other,Male,Hispanic,Yes,1,570,76,494,512,79,433
28,Other,Male,Other,No,0,244,30,214,425,23,402
28,Other,Male,Other,No,1,250,14,236,185,4,181
28,Other,Male,Other,Yes,0,140,24,116,160,19,141
28,Other,Male,Other,Yes,1,5,2,3,5,0,5
28,Other,Male,White,No,0,815,89,726,999,113,886
28,Other,Male,White,No,1,30,5,25,60,12,48
28,Other,Male,White,Yes,0,442,48,394,493,88,405
28,Other,Male,White,Yes,1,20,4,16,35,8,27
29,Elementary,Female,Black,No,0,8153,740,7413,6226,586,5640
29,Elementary,Female,Black,No,1,1189,61,1128,1160,50,1110
29,Elementary,Female,Black,Yes,0,1520,159,1361,1116,136,980
29,Elementary,Female,Black,Yes,1,50,3,47,28,1,27
29,Elementary,Female,Hispanic,No,0,1299,133,1166,1016,118,898
29,Elementary,Female,Hispanic,No,1,355,27,328,258,30,228
29,Elementary,Female,Hispanic,Yes,0,250,20,230,224,30,194
29,Elementary,Female,Hispanic,Yes,1,135,15,120,104,14,90
29,Elementary,Female,Other,No,0,1917,184,1733,1744,191,1553
29,Elementary,Female,Other,No,1,1438,89,1349,1150,78,1072
29,Elementary,Female,Other,Yes,0,305,32,273,296,36,260
29,Elementary,Female,Other,Yes,1,45,3,42,56,1,55
29,Elementary,Female,White,No,0,4065,319,3746,3039,258,2781
29,Elementary,Female,White,No,1,451,32,419,372,21,351
29,Elementary,Female,White,Yes,0,1100,109,991,788,69,719
29,Elementary,Female,White,Yes,1,25,2,23,16,0,16
29,Elementary,Male,Black,No,0,7479,642,6837,5896,558,5338
29,Elementary,Male,Black,No,1,1145,61,1084,1070,44,1026
29,Elementary,Male,Black,Yes,0,3188,336,2852,2573,242,2331
29,Elementary,Male,Black,Yes,1,160,5,155,104,15,89
29,Elementary,Male,Hispanic,No,0,1253,142,1111,994,110,884
29,Elementary,Male,Hispanic,No,1,385,32,353,332,30,302
29,Elementary,Male,Hispanic,Yes,0,445,77,368,424,60,364
29,Elementary,Male,Hispanic,Yes,1,180,31,149,116,11,105
29,Elementary,Male,Other,No,0,1745,166,1579,1586,148,1438
29,Elementary,Male,Other,No,1,1660,117,1543,1356,59,1297
29,Elementary,Male,Other,Yes,0,615,66,549,572,63,509
29,Elementary,Male,Other,Yes,1,105,6,99,76,11,65
29,Elementary,Male,White,No,0,3436,310,3126,2562,266,2296
29,Elementary,Male,White,No,1,506,43,463,440,34,406
29,Elementary,Male,White,Yes,0,1995,195,1800,1504,138,1366
29,Elementary,Male,White,Yes,1,50,4,46,44,2,42
29,High,Female,Black,No,0,3824,290,3534,3080,288,2792
29,High,Female,Black,No,1,600,34,566,688,24,664
29,High,Female,Black,Yes,0,777,85,692,627,93,534
29,High,Female,Black,Yes,1,80,4,76,56,7,49
29,High,Female,Hispanic,No,0,630,67,563,501,58,443
29,High,Female,Hispanic,No,1,380,57,323,347,63,284
29,High,Female,Hispanic,Yes,0,95,11,84,60,7,53
29,High,Female,Hispanic,Yes,1,95,9,86,68,4,64
29,High,Female,Other,No,0,374,47,327,308,20,288
29,High,Female,Other,No,1,925,59,866,786,56,730
29,High,Female,Other,Yes,0,55,7,48,44,8,36
29,High,Female,Other,Yes,1,20,2,18,28,3,25
29,High,Female,White,No,0,1829,196,1633,1481,155,1326
29,High,Female,White,No,1,200,6,194,172,8,164
29,High,Female,White,Yes,0,495,48,447,338,68,270
29,High,Male,Black,No,0,3244,252,2992,2438,207,2231
29,High,Male,Black,No,1,625,20,605,604,26,578
29,High,Male,Black,Yes,0,1330,136,1194,1061,127,934
29,High,Male,Black,Yes,1,60,0,60,68,6,62
29,High,Male,Hispanic,No,0,415,47,368,312,26,286
29,High,Male,Hispanic,No,1,430,56,374,322,37,285
29,High,Male,Hispanic,Yes,0,112,10,102,120,26,94
29,High,Male,Hispanic,Yes,1,173,24,149,157,26,131
29,High,Male,Other,No,0,265,24,241,256,18,238
29,High,Male,Other,No,1,945,59,886,754,38,716
29,High,Male,Other,Yes,0,150,16,134,100,10,90
29,High,Male,Other,Yes,1,35,0,35,28,2,26
29,High,Male,White,No,0,1468,105,1363,1187,93,1094
29,High,Male,White,No,1,270,31,239,208,20,188
29,High,Male,White,Yes,0,570,74,496,396,50,346
29,High,Male,White,Yes,1,5,1,4,4,0,4
29,Middle,Female,Black,No,0,2550,44,2506,2619,119,2500
29,Middle,Female,Black,No,1,390,10,380,488,9,479
29,Middle,Female,Black,Yes,0,470,14,456,436,32,404
29,Middle,Female,Black,Yes,1,40,1,39,44,1,43
29,Middle,Female,Hispanic,No,0,400,11,389,396,21,375
29,Middle,Female,Hispanic,No,1,238,5,233,211,11,200
29,Middle,Female,Hispanic,Yes,0,50,3,47,68,10,58
29,Middle,Female,Hispanic,Yes,1,50,1,49,65,9,56
29,Middle,Female,Other,No,0,320,7,313,288,18,270
29,Middle,Female,Other,No,1,515,6,509,496,11,485
29,Middle,Female,Other,Yes,0,70,4,66,52,9,43
29,Middle,Female,Other,Yes,1,10,0,10,4,0,4
29,Middle,Female,White,No,0,1445,31,1414,1225,65,1160
29,Middle,Female,White,No,1,150,2,148,148,6,142
29,Middle,Female,White,Yes,0,290,10,280,276,21,255
29,Middle,Female,White,Yes,1,5,0,5,8,1,7
29,Middle,Male,Black,No,0,2227,29,2198,2362,102,2260
29,Middle,Male,Black,No,1,360,7,353,500,4,496
29,Middle,Male,Black,Yes,0,1115,30,1085,1040,58,982
29,Middle,Male,Black,Yes,1,70,2,68,52,2,50
29,Middle,Male,Hispanic,No,0,320,4,316,400,24,376
29,Middle,Male,Hispanic,No,1,206,7,199,148,12,136
29,Middle,Male,Hispanic,Yes,0,190,4,186,164,12,152
29,Middle,Male,Hispanic,Yes,1,60,0,60,112,5,107
29,Middle,Male,Other,No,0,335,7,328,316,20,296
29,Middle,Male,Other,No,1,580,8,572,486,8,478
29,Middle,Male,Other,Yes,0,100,5,95,68,8,60
29,Middle,Male,Other,Yes,1,55,1,54,60,2,58
29,Middle,Male,White,No,0,1476,37,1439,1131,60,1071
29,Middle,Male,White,No,1,175,4,171,188,7,181
29,Middle,Male,White,Yes,0,625,23,602,620,55,565
29,Middle,Male,White,Yes,1,15,0,15,4,0,4
29,Other,Female,Black,No,0,2530,254,2276,2380,333,2047
29,Other,Female,Black,No,1,190,7,183,140,15,125
29,Other,Female,Black,Yes,0,335,59,276,395,73,322
29,Other,Female,Black,Yes,1,12,1,11,8,1,7
29,Other,Female,Hispanic,No,0,760,95,665,700,97,603
29,Other,Female,Hispanic,No,1,905,151,754,760,128,632
29,Other,Female,Hispanic,Yes,0,80,7,73,96,18,78
29,Other,Female,Hispanic,Yes,1,230,27,203,164,25,139
29,Other,Female,Other,No,0,325,49,276,421,45,376
29,Other,Female,Other,No,1,255,13,242,165,7,158
29,Other,Female,Other,Yes,0,40,7,33,40,6,34
29,Other,Female,Other,Yes,1,10,2,8,8,0,8
29,Other,Female,White,No,0,629,76,553,696,118,578
29,Other,Female,White,No,1,55,4,51,64,3,61
29,Other,Female,White,Yes,0,165,23,142,190,43,147
29,Other,Female,White,Yes,1,10,0,10,8,0,8
29,Other,Male,Black,No,0,2535,218,2317,2324,278,2046
29,Other,Male,Black,No,1,165,15,150,192,12,180
29,Other,Male,Black,Yes,0,911,127,784,822,126,696
29,Other,Male,Black,Yes,1,30,4,26,36,5,31
29,Other,Male,Hispanic,No,0,680,98,582,598,78,520
29,Other,Male,Hispanic,No,1,968,174,794,736,124,612
29,Other,Male,Hispanic,Yes,0,285,44,241,256,62,194
29,Other,Male,Hispanic,Yes,1,570,82,488,412,70,342
29,Other,Male,Other,No,0,245,37,208,336,15,321
29,Other,Male,Other,No,1,250,9,241,143,8,135
29,Other,Male,Other,Yes,0,140,21,119,131,11,120
29,Other,Male,Other,Yes,1,5,0,5,4,0,4
29,Other,Male,White,No,0,810,99,711,800,114,686
29,Other,Male,White,No,1,35,6,29,48,10,38
29,Other,Male,White,Yes,0,445,64,381,412,71,341
29,Other,Male,White,Yes,1,20,5,15,28,4,24
30,Elementary,Female,Black,No,0,1631,167,1464,7801,711,7090
30,Elementary,Female,Black,No,1,238,8,230,1472,82,1390
30,Elementary,Female,Black,Yes,0,304,41,263,1395,189,1206
30,Elementary,Female,Black,Yes,1,10,0,10,35,0,35
30,Elementary,Female,Hispanic,No,0,259,29,230,1269,143,1126
30,Elementary,Female,Hispanic,No,1,71,8,63,325,57,268
30,Elementary,Female,Hispanic,Yes,0,50,9,41,279,50,229
30,Elementary,Female,Hispanic,Yes,1,27,5,22,130,26,104
30,Elementary,Female,Other,No,0,384,42,342,2180,232,1948
30,Elementary,Female,Other,No,1,287,12,275,1431,85,1346
30,Elementary,Female,Other,Yes,0,61,9,52,370,42,328
30,Elementary,Female,Other,Yes,1,9,1,8,70,11,59
30,Elementary,Female,White,No,0,813,68,745,3801,356,3445
30,Elementary,Female,White,No,1,90,14,76,465,47,418
30,Elementary,Female,White,Yes,0,220,27,193,986,116,870
30,Elementary,Female,White,Yes,1,5,0,5,20,0,20
30,Elementary,Male,Black,No,0,1497,150,1347,7366,639,6727
30,Elementary,Male,Black,No,1,229,13,216,1347,61,1286
30,Elementary,Male,Black,Yes,0,638,94,544,3220,321,2899
30,Elementary,Male,Black,Yes,1,32,3,29,130,14,116
30,Elementary,Male,Hispanic,No,0,250,26,224,1248,125,1123
30,Elementary,Male,Hispanic,No,1,77,13,64,415,49,366
30,Elementary,Male,Hispanic,Yes,0,89,17,72,526,63,463
30,Elementary,Male,Hispanic,Yes,1,36,6,30,145,23,122
30,Elementary,Male,Other,No,0,349,36,313,1974,203,1771
30,Elementary,Male,Other,No,1,332,25,307,1695,84,1611
30,Elementary,Male,Other,Yes,0,123,16,107,715,68,647
30,Elementary,Male,Other,Yes,1,21,0,21,95,12,83
30,Elementary,Male,White,No,0,688,68,620,3208,295,2913
30,Elementary,Male,White,No,1,102,10,92,550,47,503
30,Elementary,Male,White,Yes,0,399,48,351,1878,217,1661
30,Elementary,Male,White,Yes,1,10,0,10,55,2,53
30,High,Female,Black,No,0,766,53,713,3830,377,3453
30,High,Female,Black,No,1,120,3,117,860,28,832
30,High,Female,Black,Yes,0,154,14,140,782,127,655
30,High,Female,Black,Yes,1,16,1,15,70,8,62
30,High,Female,Hispanic,No,0,126,8,118,625,61,564
30,High,Female,Hispanic,No,1,76,15,61,434,88,346
30,High,Female,Hispanic,Yes,0,19,3,16,70,13,57
30,High,Female,Hispanic,Yes,1,19,1,18,85,9,76
30,High,Female,Other,No,0,75,12,63,385,30,355
30,High,Female,Other,No,1,185,10,175,986,71,915
30,High,Female,Other,Yes,0,11,1,10,54,10,44
30,High,Female,Other,Yes,1,4,1,3,35,5,30
30,High,Female,White,No,0,364,35,329,1855,198,1657
30,High,Female,White,No,1,40,1,39,215,13,202
30,High,Female,White,Yes,0,99,4,95,420,77,343
30,High,Male,Black,No,0,646,36,610,3016,295,2721
30,High,Male,Black,No,1,125,2,123,756,30,726
30,High,Male,Black,Yes,0,266,32,234,1323,169,1154
30,High,Male,Black,Yes,1,12,0,12,85,8,77
30,High,Male,Hispanic,No,0,83,6,77,390,32,358
30,High,Male,Hispanic,No,1,86,12,74,400,51,349
30,High,Male,Hispanic,Yes,0,22,1,21,150,24,126
30,High,Male,Hispanic,Yes,1,34,5,29,195,35,160
30,High,Male,Other,No,0,53,1,52,320,14,306
30,High,Male,Other,No,1,189,13,176,939,71,868
30,High,Male,Other,Yes,0,30,3,27,125,6,119
30,High,Male,Other,Yes,1,7,0,7,35,2,33
30,High,Male,White,No,0,293,23,270,1483,119,1364
30,High,Male,White,No,1,54,3,51,260,25,235
30,High,Male,White,Yes,0,114,14,100,501,61,440
30,High,Male,White,Yes,1,1,0,1,5,0,5
30,Middle,Female,Black,No,0,510,10,500,3274,106,3168
30,Middle,Female,Black,No,1,78,0,78,610,5,605
30,Middle,Female,Black,Yes,0,94,2,92,548,22,526
30,Middle,Female,Black,Yes,1,8,1,7,55,1,54
30,Middle,Female,Hispanic,No,0,80,1,79,499,22,477
30,Middle,Female,Hispanic,No,1,48,2,46,269,5,264
30,Middle,Female,Hispanic,Yes,0,10,0,10,85,4,81
30,Middle,Female,Hispanic,Yes,1,10,1,9,85,9,76
30,Middle,Female,Other,No,0,64,0,64,360,15,345
30,Middle,Female,Other,No,1,103,1,102,620,12,608
30,Middle,Female,Other,Yes,0,14,0,14,60,11,49
30,Middle,Female,Other,Yes,1,2,0,2,5,0,5
30,Middle,Female,White,No,0,289,5,284,1530,65,1465
30,Middle,Female,White,No,1,30,0,30,189,6,183
30,Middle,Female,White,Yes,0,58,0,58,345,24,321
30,Middle,Female,White,Yes,1,1,0,1,10,0,10
30,Middle,Male,Black,No,0,446,8,438,2974,89,2885
30,Middle,Male,Black,No,1,72,2,70,628,14,614
30,Middle,Male,Black,Yes,0,223,2,221,1295,63,1232
30,Middle,Male,Black,Yes,1,14,0,14,65,6,59
30,Middle,Male,Hispanic,No,0,64,0,64,497,17,480
30,Middle,Male,Hispanic,No,1,41,1,40,183,11,172
30,Middle,Male,Hispanic,Yes,0,38,3,35,205,16,189
30,Middle,Male,Hispanic,Yes,1,12,0,12,140,9,131
30,Middle,Male,Other,No,0,67,1,66,395,14,381
30,Middle,Male,Other,No,1,116,0,116,610,6,604
30,Middle,Male,Other,Yes,0,20,0,20,82,9,73
30,Middle,Male,Other,Yes,1,11,0,11,75,7,68
30,Middle,Male,White,No,0,295,6,289,1411,60,1351
30,Middle,Male,White,No,1,35,0,35,235,8,227
30,Middle,Male,White,Yes,0,125,7,118,774,71,703
30,Middle,Male,White,Yes,1,3,0,3,5,1,4
30,Other,Female,Black,No,0,512,45,467,2979,370,2609
30,Other,Female,Black,No,1,47,3,44,177,26,151
30,Other,Female,Black,Yes,0,67,9,58,476,77,399
30,Other,Female,Black,Yes,1,4,0,4,10,1,9
30,Other,Female,Hispanic,No,0,153,19,134,863,109,754
30,Other,Female,Hispanic,No,1,182,29,153,945,125,820
30,Other,Female,Hispanic,Yes,0,16,1,15,120,17,103
30,Other,Female,Hispanic,Yes,1,46,11,35,205,26,179
30,Other,Female,Other,No,0,69,7,62,524,42,482
30,Other,Female,Other,No,1,68,4,64,205,5,200
30,Other,Female,Other,Yes,0,8,0,8,53,4,49
30,Other,Female,Other,Yes,1,2,0,2,10,0,10
30,Other,Female,White,No,0,128,16,112,867,125,742
30,Other,Female,White,No,1,11,0,11,80,11,69
30,Other,Female,White,Yes,0,33,2,31,227,46,181
30,Other,Female,White,Yes,1,2,0,2,10,3,7
30,Other,Male,Black,No,0,511,38,473,2903,303,2600
30,Other,Male,Black,No,1,39,2,37,243,26,217
30,Other,Male,Black,Yes,0,184,24,160,996,161,835
30,Other,Male,Black,Yes,1,6,0,6,45,7,38
30,Other,Male,Hispanic,No,0,136,20,116,749,106,643
30,Other,Male,Hispanic,No,1,196,40,156,921,125,796
30,Other,Male,Hispanic,Yes,0,57,12,45,305,70,235
30,Other,Male,Hispanic,Yes,1,114,24,90,504,78,426
30,Other,Male,Other,No,0,50,4,46,422,44,378
30,Other,Male,Other,No,1,66,0,66,175,3,172
30,Other,Male,Other,Yes,0,28,3,25,156,18,138
30,Other,Male,Other,Yes,1,2,0,2,5,0,5
30,Other,Male,White,No,0,162,15,147,1004,127,877
30,Other,Male,White,No,1,7,1,6,60,10,50
30,Other,Male,White,Yes,0,89,11,78,485,90,395
30,Other,Male,White,Yes,1,4,1,3,35,7,28
31,Elementary,Female,Black,No,0,4891,339,4552,7806,612,7194
31,Elementary,Female,Black,No,1,714,28,686,1470,64,1406
31,Elementary,Female,Black,Yes,0,912,76,836,1390,124,1266
31,Elementary,Female,Black,Yes,1,30,0,30,35,0,35
31,Elementary,Female,Hispanic,No,0,776,55,721,1265,153,1112
31,Elementary,Female,Hispanic,No,1,213,17,196,320,53,267
31,Elementary,Female,Hispanic,Yes,0,150,19,131,275,42,233
31,Elementary,Female,Hispanic,Yes,1,84,12,72,130,24,106
31,Elementary,Female,Other,No,0,1155,91,1064,2176,216,1960
31,Elementary,Female,Other,No,1,861,31,830,1430,59,1371
31,Elementary,Female,Other,Yes,0,183,13,170,370,49,321
31,Elementary,Female,Other,Yes,1,27,2,25,70,10,60
31,Elementary,Female,White,No,0,2436,137,2299,3789,267,3522
31,Elementary,Female,White,No,1,270,16,254,459,28,431
31,Elementary,Female,White,Yes,0,660,56,604,984,86,898
31,Elementary,Female,White,Yes,1,15,0,15,20,1,19
31,Elementary,Male,Black,No,0,4492,256,4236,7359,491,6868
31,Elementary,Male,Black,No,1,687,26,661,1340,54,1286
31,Elementary,Male,Black,Yes,0,1920,130,1790,3222,289,2933
31,Elementary,Male,Black,Yes,1,96,6,90,130,16,114
31,Elementary,Male,Hispanic,No,0,745,58,687,1242,114,1128
31,Elementary,Male,Hispanic,No,1,231,25,206,415,35,380
31,Elementary,Male,Hispanic,Yes,0,263,20,243,526,61,465
31,Elementary,Male,Hispanic,Yes,1,108,15,93,145,19,126
31,Elementary,Male,Other,No,0,1049,57,992,1970,142,1828
31,Elementary,Male,Other,No,1,999,27,972,1695,67,1628
31,Elementary,Male,Other,Yes,0,366,25,341,712,66,646
31,Elementary,Male,Other,Yes,1,63,3,60,95,9,86
31,Elementary,Male,White,No,0,2064,108,1956,3198,258,2940
31,Elementary,Male,White,No,1,300,10,290,550,39,511
31,Elementary,Male,White,Yes,0,1193,92,1101,1873,176,1697
31,Elementary,Male,White,Yes,1,30,2,28,55,4,51
31,High,Female,Black,No,0,2297,167,2130,3774,380,3394
31,High,Female,Black,No,1,360,17,343,868,28,840
31,High,Female,Black,Yes,0,462,39,423,773,107,666
31,High,Female,Black,Yes,1,48,3,45,68,2,66
31,High,Female,Hispanic,No,0,378,35,343,622,77,545
31,High,Female,Hispanic,No,1,228,36,192,434,86,348
31,High,Female,Hispanic,Yes,0,57,8,49,70,6,64
31,High,Female,Hispanic,Yes,1,57,8,49,85,7,78
31,High,Female,Other,No,0,225,23,202,377,42,335
31,High,Female,Other,No,1,555,35,520,988,76,912
31,High,Female,Other,Yes,0,30,0,30,50,8,42
31,High,Female,Other,Yes,1,12,0,12,35,2,33
31,High,Female,White,No,0,1092,108,984,1845,209,1636
31,High,Female,White,No,1,120,7,113,215,9,206
31,High,Female,White,Yes,0,297,22,275,421,54,367
31,High,Male,Black,No,0,1922,139,1783,2983,260,2723
31,High,Male,Black,No,1,375,14,361,756,16,740
31,High,Male,Black,Yes,0,800,86,714,1311,154,1157
31,High,Male,Black,Yes,1,36,1,35,85,7,78
31,High,Male,Hispanic,No,0,249,28,221,385,22,363
31,High,Male,Hispanic,No,1,258,36,222,393,39,354
31,High,Male,Hispanic,Yes,0,66,5,61,148,28,120
31,High,Male,Hispanic,Yes,1,102,15,87,195,33,162
31,High,Male,Other,No,0,159,8,151,312,13,299
31,High,Male,Other,No,1,567,40,527,935,58,877
31,High,Male,Other,Yes,0,89,7,82,125,8,117
31,High,Male,Other,Yes,1,21,2,19,35,3,32
31,High,Male,White,No,0,875,59,816,1471,105,1366
31,High,Male,White,No,1,162,14,148,260,32,228
31,High,Male,White,Yes,0,345,41,304,505,58,447
31,High,Male,White,Yes,1,3,1,2,5,0,5
31,Middle,Female,Black,No,0,1530,11,1519,3277,85,3192
31,Middle,Female,Black,No,1,234,1,233,610,8,602
31,Middle,Female,Black,Yes,0,282,10,272,550,27,523
31,Middle,Female,Black,Yes,1,24,0,24,51,1,50
31,Middle,Female,Hispanic,No,0,243,1,242,500,35,465
31,Middle,Female,Hispanic,No,1,144,7,137,270,4,266
31,Middle,Female,Hispanic,Yes,0,30,1,29,85,7,78
31,Middle,Female,Hispanic,Yes,1,30,1,29,81,12,69
31,Middle,Female,Other,No,0,192,4,188,360,19,341
31,Middle,Female,Other,No,1,309,3,306,620,17,603
31,Middle,Female,Other,Yes,0,42,1,41,60,14,46
31,Middle,Female,Other,Yes,1,6,0,6,5,0,5
31,Middle,Female,White,No,0,858,14,844,1530,77,1453
31,Middle,Female,White,No,1,90,0,90,190,9,181
31,Middle,Female,White,Yes,0,175,3,172,343,21,322
31,Middle,Female,White,Yes,1,3,0,3,10,0,10
31,Middle,Male,Black,No,0,1347,13,1334,2983,73,2910
31,Middle,Male,Black,No,1,213,4,209,634,2,632
31,Middle,Male,Black,Yes,0,666,13,653,1295,55,1240
31,Middle,Male,Black,Yes,1,42,0,42,65,3,62
31,Middle,Male,Hispanic,No,0,192,4,188,495,15,480
31,Middle,Male,Hispanic,No,1,123,2,121,175,7,168
31,Middle,Male,Hispanic,Yes,0,114,3,111,205,20,185
31,Middle,Male,Hispanic,Yes,1,36,2,34,140,6,134
31,Middle,Male,Other,No,0,201,2,199,395,19,376
31,Middle,Male,Other,No,1,348,2,346,610,7,603
31,Middle,Male,Other,Yes,0,60,3,57,82,6,76
31,Middle,Male,Other,Yes,1,33,1,32,75,3,72
31,Middle,Male,White,No,0,873,22,851,1405,60,1345
31,Middle,Male,White,No,1,105,0,105,235,12,223
31,Middle,Male,White,Yes,0,369,17,352,775,66,709
31,Middle,Male,White,Yes,1,9,0,9,5,0,5
31,Other,Female,Black,No,0,1521,144,1377,2992,367,2625
31,Other,Female,Black,No,1,114,5,109,180,24,156
31,Other,Female,Black,Yes,0,201,29,172,484,82,402
31,Other,Female,Black,Yes,1,9,1,8,10,0,10
31,Other,Female,Hispanic,No,0,459,60,399,867,97,770
31,Other,Female,Hispanic,No,1,558,72,486,945,125,820
31,Other,Female,Hispanic,Yes,0,48,1,47,124,14,110
31,Other,Female,Hispanic,Yes,1,135,15,120,201,28,173
31,Other,Female,Other,No,0,195,13,182,530,49,481
31,Other,Female,Other,No,1,153,6,147,209,7,202
31,Other,Female,Other,Yes,0,24,6,18,55,5,50
31,Other,Female,Other,Yes,1,6,0,6,10,0,10
31,Other,Female,White,No,0,381,34,347,878,107,771
31,Other,Female,White,No,1,33,0,33,80,8,72
31,Other,Female,White,Yes,0,99,13,86,225,54,171
31,Other,Female,White,Yes,1,6,1,5,10,2,8
31,Other,Male,Black,No,0,1526,138,1388,2910,279,2631
31,Other,Male,Black,No,1,99,5,94,245,24,221
31,Other,Male,Black,Yes,0,540,57,483,1000,139,861
31,Other,Male,Black,Yes,1,18,6,12,45,4,41
31,Other,Male,Hispanic,No,0,411,63,348,738,83,655
31,Other,Male,Hispanic,No,1,588,72,516,916,111,805
31,Other,Male,Hispanic,Yes,0,171,35,136,311,56,255
31,Other,Male,Hispanic,Yes,1,342,45,297,496,81,415
31,Other,Male,Other,No,0,147,20,127,430,22,408
31,Other,Male,Other,No,1,150,7,143,175,5,170
31,Other,Male,Other,Yes,0,84,13,71,161,18,143
31,Other,Male,Other,Yes,1,3,0,3,5,0,5
31,Other,Male,White,No,0,484,37,447,1015,103,912
31,Other,Male,White,No,1,21,3,18,58,7,51
31,Other,Male,White,Yes,0,268,36,232,487,84,403
31,Other,Male,White,Yes,1,12,2,10,35,10,25
32,Elementary,Female,Black,No,0,8137,616,7521,7798,569,7229
32,Elementary,Female,Black,No,1,1190,44,1146,1460,44,1416
32,Elementary,Female,Black,Yes,0,1520,104,1416,1390,126,1264
32,Elementary,Female,Black,Yes,1,50,2,48,35,0,35
32,Elementary,Female,Hispanic,No,0,1294,111,1183,1268,130,1138
32,Elementary,Female,Hispanic,No,1,352,37,315,322,57,265
32,Elementary,Female,Hispanic,Yes,0,250,26,224,275,38,237
32,Elementary,Female,Hispanic,Yes,1,140,15,125,130,19,111
32,Elementary,Female,Other,No,0,1924,200,1724,2170,172,1998
32,Elementary,Female,Other,No,1,1440,68,1372,1432,68,1364
32,Elementary,Female,Other,Yes,0,305,31,274,369,38,331
32,Elementary,Female,Other,Yes,1,45,3,42,70,5,65
32,Elementary,Female,White,No,0,4051,291,3760,3775,234,3541
32,Elementary,Female,White,No,1,450,28,422,459,13,446
32,Elementary,Female,White,Yes,0,1101,108,993,985,69,916
32,Elementary,Female,White,Yes,1,25,0,25,20,0,20
32,Elementary,Male,Black,No,0,7481,577,6904,7374,556,6818
32,Elementary,Male,Black,No,1,1145,54,1091,1337,65,1272
32,Elementary,Male,Black,Yes,0,3200,284,2916,3222,300,2922
32,Elementary,Male,Black,Yes,1,160,11,149,130,9,121
32,Elementary,Male,Hispanic,No,0,1233,121,1112,1245,107,1138
32,Elementary,Male,Hispanic,No,1,385,31,354,415,24,391
32,Elementary,Male,Hispanic,Yes,0,435,33,402,536,76,460
32,Elementary,Male,Hispanic,Yes,1,180,33,147,145,28,117
32,Elementary,Male,Other,No,0,1751,140,1611,1970,188,1782
32,Elementary,Male,Other,No,1,1670,72,1598,1690,68,1622
32,Elementary,Male,Other,Yes,0,610,47,563,710,55,655
32,Elementary,Male,Other,Yes,1,105,5,100,95,12,83
32,Elementary,Male,White,No,0,3442,256,3186,3184,249,2935
32,Elementary,Male,White,No,1,497,39,458,554,35,519
32,Elementary,Male,White,Yes,0,1985,181,1804,1875,151,1724
32,Elementary,Male,White,Yes,1,50,3,47,55,4,51
32,High,Female,Black,No,0,3819,307,3512,3738,345,3393
32,High,Female,Black,No,1,600,27,573,870,34,836
32,High,Female,Black,Yes,0,770,75,695,764,103,661
32,High,Female,Black,Yes,1,80,5,75,65,2,63
32,High,Female,Hispanic,No,0,630,50,580,619,77,542
32,High,Female,Hispanic,No,1,375,60,315,434,76,358
32,High,Female,Hispanic,Yes,0,95,10,85,70,12,58
32,High,Female,Hispanic,Yes,1,95,14,81,85,7,78
32,High,Female,Other,No,0,374,33,341,375,41,334
32,High,Female,Other,No,1,925,63,862,991,79,912
32,High,Female,Other,Yes,0,50,2,48,50,6,44
32,High,Female,Other,Yes,1,20,1,19,35,4,31
32,High,Female,White,No,0,1821,174,1647,1841,199,1642
32,High,Female,White,No,1,200,11,189,215,12,203
32,High,Female,White,Yes,0,499,44,455,422,58,364
32,High,Male,Black,No,0,3144,238,2906,2953,253,2700
32,High,Male,Black,No,1,625,17,608,755,19,736
32,High,Male,Black,Yes,0,1325,165,1160,1304,161,1143
32,High,Male,Black,Yes,1,60,4,56,85,7,78
32,High,Male,Hispanic,No,0,415,52,363,386,18,368
32,High,Male,Hispanic,No,1,421,59,362,390,38,352
32,High,Male,Hispanic,Yes,0,110,16,94,145,26,119
32,High,Male,Hispanic,Yes,1,170,30,140,190,30,160
32,High,Male,Other,No,0,263,21,242,310,19,291
32,High,Male,Other,No,1,945,62,883,931,71,860
32,High,Male,Other,Yes,0,145,18,127,125,10,115
32,High,Male,Other,Yes,1,35,1,34,35,2,33
32,High,Male,White,No,0,1451,125,1326,1467,98,1369
32,High,Male,White,No,1,270,25,245,260,26,234
32,High,Male,White,Yes,0,570,80,490,505,58,447
32,High,Male,White,Yes,1,5,1,4,5,0,5
32,Middle,Female,Black,No,0,2547,27,2520,3279,114,3165
32,Middle,Female,Black,No,1,393,10,383,610,4,606
32,Middle,Female,Black,Yes,0,468,15,453,550,22,528
32,Middle,Female,Black,Yes,1,40,0,40,50,0,50
32,Middle,Female,Hispanic,No,0,405,8,397,503,23,480
32,Middle,Female,Hispanic,No,1,240,8,232,270,11,259
32,Middle,Female,Hispanic,Yes,0,50,0,50,85,3,82
32,Middle,Female,Hispanic,Yes,1,47,1,46,80,2,78
32,Middle,Female,Other,No,0,318,8,310,360,12,348
32,Middle,Female,Other,No,1,515,4,511,617,20,597
32,Middle,Female,Other,Yes,0,70,0,70,60,16,44
32,Middle,Female,Other,Yes,1,10,1,9,5,1,4
32,Middle,Female,White,No,0,1435,25,1410,1526,77,1449
32,Middle,Female,White,No,1,150,1,149,190,12,178
32,Middle,Female,White,Yes,0,292,3,289,340,14,326
32,Middle,Female,White,Yes,1,5,0,5,10,0,10
32,Middle,Male,Black,No,0,2238,35,2203,2984,87,2897
32,Middle,Male,Black,No,1,355,4,351,631,4,627
32,Middle,Male,Black,Yes,0,1109,22,1087,1290,58,1232
32,Middle,Male,Black,Yes,1,70,2,68,65,3,62
32,Middle,Male,Hispanic,No,0,320,5,315,497,20,477
32,Middle,Male,Hispanic,No,1,205,3,202,175,8,167
32,Middle,Male,Hispanic,Yes,0,190,3,187,205,23,182
32,Middle,Male,Hispanic,Yes,1,60,1,59,141,6,135
32,Middle,Male,Other,No,0,336,10,326,395,15,380
32,Middle,Male,Other,No,1,580,2,578,610,12,598
32,Middle,Male,Other,Yes,0,100,7,93,84,6,78
32,Middle,Male,Other,Yes,1,55,0,55,75,2,73
32,Middle,Male,White,No,0,1462,23,1439,1400,65,1335
32,Middle,Male,White,No,1,175,4,171,235,8,227
32,Middle,Male,White,Yes,0,615,29,586,775,68,707
32,Middle,Male,White,Yes,1,15,0,15,5,0,5
32,Other,Female,Black,No,0,2503,234,2269,3025,386,2639
32,Other,Female,Black,No,1,185,9,176,180,28,152
32,Other,Female,Black,Yes,0,335,57,278,485,99,386
32,Other,Female,Black,Yes,1,15,0,15,10,0,10
32,Other,Female,Hispanic,No,0,754,94,660,874,99,775
32,Other,Female,Hispanic,No,1,930,127,803,945,109,836
32,Other,Female,Hispanic,Yes,0,80,11,69,125,11,114
32,Other,Female,Hispanic,Yes,1,225,24,201,200,25,175
32,Other,Female,Other,No,0,321,35,286,531,56,475
32,Other,Female,Other,No,1,259,12,247,215,6,209
32,Other,Female,Other,Yes,0,40,6,34,55,3,52
32,Other,Female,Other,Yes,1,10,0,10,10,0,10
32,Other,Female,White,No,0,630,71,559,874,113,761
32,Other,Female,White,No,1,55,2,53,80,9,71
32,Other,Female,White,Yes,0,165,11,154,225,41,184
32,Other,Female,White,Yes,1,10,2,8,10,4,6
32,Other,Male,Black,No,0,2549,243,2306,2924,363,2561
32,Other,Male,Black,No,1,165,7,158,245,16,229
32,Other,Male,Black,Yes,0,899,115,784,1014,150,864
32,Other,Male,Black,Yes,1,30,2,28,45,5,40
32,Other,Male,Hispanic,No,0,665,74,591,722,79,643
32,Other,Male,Hispanic,No,1,975,137,838,915,120,795
32,Other,Male,Hispanic,Yes,0,279,48,231,310,71,239
32,Other,Male,Hispanic,Yes,1,565,71,494,494,73,421
32,Other,Male,Other,No,0,249,29,220,435,35,400
32,Other,Male,Other,No,1,253,6,247,175,5,170
32,Other,Male,Other,Yes,0,143,21,122,160,24,136
32,Other,Male,Other,Yes,1,5,0,5,5,0,5
32,Other,Male,White,No,0,813,71,742,1024,108,916
32,Other,Male,White,No,1,35,7,28,60,9,51
32,Other,Male,White,Yes,0,437,41,396,487,72,415
32,Other,Male,White,Yes,1,20,4,16,35,7,28
33,Elementary,Female,Black,No,0,8145,580,7565,1556,158,1398
33,Elementary,Female,Black,No,1,1190,47,1143,295,10,285
33,Elementary,Female,Black,Yes,0,1520,112,1408,278,37,241
33,Elementary,Female,Black,Yes,1,50,1,49,7,0,7
33,Elementary,Female,Hispanic,No,0,1290,108,1182,254,38,216
33,Elementary,Female,Hispanic,No,1,353,34,319,65,18,47
33,Elementary,Female,Hispanic,Yes,0,252,17,235,55,10,45
33,Elementary,Female,Hispanic,Yes,1,140,16,124,26,5,21
33,Elementary,Female,Other,No,0,1915,169,1746,434,57,377
33,Elementary,Female,Other,No,1,1440,73,1367,287,13,274
33,Elementary,Female,Other,Yes,0,305,35,270,73,8,65
33,Elementary,Female,Other,Yes,1,45,2,43,14,2,12
33,Elementary,Female,White,No,0,4051,274,3777,756,73,683
33,Elementary,Female,White,No,1,450,29,421,93,6,87
33,Elementary,Female,White,Yes,0,1100,104,996,197,25,172
33,Elementary,Female,White,Yes,1,29,0,29,4,0,4
33,Elementary,Male,Black,No,0,7479,537,6942,1475,173,1302
33,Elementary,Male,Black,No,1,1144,47,1097,269,21,248
33,Elementary,Male,Black,Yes,0,3200,311,2889,644,93,551
33,Elementary,Male,Black,Yes,1,160,4,156,26,3,23
33,Elementary,Male,Hispanic,No,0,1230,105,1125,249,33,216
33,Elementary,Male,Hispanic,No,1,385,31,354,83,8,75
33,Elementary,Male,Hispanic,Yes,0,435,36,399,108,18,90
33,Elementary,Male,Hispanic,Yes,1,180,37,143,29,5,24
33,Elementary,Male,Other,No,0,1755,134,1621,394,47,347
33,Elementary,Male,Other,No,1,1670,68,1602,337,20,317
33,Elementary,Male,Other,Yes,0,610,47,563,142,18,124
33,Elementary,Male,Other,Yes,1,105,10,95,19,2,17
33,Elementary,Male,White,No,0,3438,240,3198,637,74,563
33,Elementary,Male,White,No,1,495,40,455,112,12,100
33,Elementary,Male,White,Yes,0,1985,174,1811,375,37,338
33,Elementary,Male,White,Yes,1,50,6,44,11,3,8
33,High,Female,Black,No,0,3818,289,3529,746,58,688
33,High,Female,Black,No,1,600,34,566,174,10,164
33,High,Female,Black,Yes,0,774,69,705,153,17,136
33,High,Female,Black,Yes,1,80,1,79,13,0,13
33,High,Female,Hispanic,No,0,624,59,565,124,14,110
33,High,Female,Hispanic,No,1,375,53,322,87,11,76
33,High,Female,Hispanic,Yes,0,95,9,86,14,2,12
33,High,Female,Hispanic,Yes,1,95,15,80,17,1,16
33,High,Female,Other,No,0,375,43,332,75,5,70
33,High,Female,Other,No,1,917,49,868,198,13,185
33,High,Female,Other,Yes,0,50,2,48,10,0,10
33,High,Female,Other,Yes,1,20,1,19,7,0,7
33,High,Female,White,No,0,1813,174,1639,368,37,331
33,High,Female,White,No,1,200,10,190,43,3,40
33,High,Female,White,Yes,0,500,53,447,83,8,75
33,High,Male,Black,No,0,3117,205,2912,588,35,553
33,High,Male,Black,No,1,625,12,613,151,2,149
33,High,Male,Black,Yes,0,1312,179,1133,259,20,239
33,High,Male,Black,Yes,1,60,1,59,17,1,16
33,High,Male,Hispanic,No,0,415,45,370,78,4,74
33,High,Male,Hispanic,No,1,416,50,366,78,4,74
33,High,Male,Hispanic,Yes,0,110,6,104,29,3,26
33,High,Male,Hispanic,Yes,1,170,27,143,38,4,34
33,High,Male,Other,No,0,265,25,240,62,3,59
33,High,Male,Other,No,1,946,71,875,186,10,176
33,High,Male,Other,Yes,0,145,17,128,25,1,24
33,High,Male,Other,Yes,1,35,1,34,7,0,7
33,High,Male,White,No,0,1449,117,1332,293,15,278
33,High,Male,White,No,1,270,29,241,52,2,50
33,High,Male,White,Yes,0,564,74,490,101,16,85
33,High,Male,White,Yes,1,5,0,5,1,0,1
33,Middle,Female,Black,No,0,2539,29,2510,656,18,638
33,Middle,Female,Black,No,1,395,4,391,122,1,121
33,Middle,Female,Black,Yes,0,465,14,451,110,3,107
33,Middle,Female,Black,Yes,1,40,0,40,10,0,10
33,Middle,Female,Hispanic,No,0,405,7,398,101,6,95
33,Middle,Female,Hispanic,No,1,245,6,239,54,2,52
33,Middle,Female,Hispanic,Yes,0,50,1,49,17,1,16
33,Middle,Female,Hispanic,Yes,1,45,0,45,16,5,11
33,Middle,Female,Other,No,0,311,14,297,72,6,66
33,Middle,Female,Other,No,1,516,6,510,123,5,118
33,Middle,Female,Other,Yes,0,70,5,65,12,3,9
33,Middle,Female,Other,Yes,1,10,1,9,1,0,1
33,Middle,Female,White,No,0,1440,28,1412,305,26,279
33,Middle,Female,White,No,1,150,2,148,38,3,35
33,Middle,Female,White,Yes,0,289,13,276,68,3,65
33,Middle,Female,White,Yes,1,5,0,5,2,1,1
33,Middle,Male,Black,No,0,2231,37,2194,595,14,581
33,Middle,Male,Black,No,1,355,6,349,126,3,123
33,Middle,Male,Black,Yes,0,1110,28,1082,257,15,242
33,Middle,Male,Black,Yes,1,70,2,68,13,0,13
33,Middle,Male,Hispanic,No,0,320,5,315,100,4,96
33,Middle,Male,Hispanic,No,1,205,3,202,35,6,29
33,Middle,Male,Hispanic,Yes,0,188,8,180,41,5,36
33,Middle,Male,Hispanic,Yes,1,60,1,59,29,4,25
33,Middle,Male,Other,No,0,340,16,324,79,6,73
33,Middle,Male,Other,No,1,580,2,578,122,3,119
33,Middle,Male,Other,Yes,0,100,3,97,17,1,16
33,Middle,Male,Other,Yes,1,55,0,55,15,0,15
33,Middle,Male,White,No,0,1464,36,1428,280,24,256
33,Middle,Male,White,No,1,175,2,173,47,0,47
33,Middle,Male,White,Yes,0,613,29,584,155,23,132
33,Middle,Male,White,Yes,1,15,0,15,1,0,1
33,Other,Female,Black,No,0,2491,214,2277,610,65,545
33,Other,Female,Black,No,1,180,9,171,36,4,32
33,Other,Female,Black,Yes,0,336,50,286,96,17,79
33,Other,Female,Black,Yes,1,15,0,15,2,1,1
33,Other,Female,Hispanic,No,0,747,92,655,175,28,147
33,Other,Female,Hispanic,No,1,932,150,782,189,29,160
33,Other,Female,Hispanic,Yes,0,80,14,66,25,2,23
33,Other,Female,Hispanic,Yes,1,222,21,201,40,3,37
33,Other,Female,Other,No,0,320,43,277,107,14,93
33,Other,Female,Other,No,1,262,12,250,43,0,43
33,Other,Female,Other,Yes,0,40,6,34,11,0,11
33,Other,Female,Other,Yes,1,10,0,10,2,0,2
33,Other,Female,White,No,0,633,72,561,175,15,160
33,Other,Female,White,No,1,55,2,53,16,2,14
33,Other,Female,White,Yes,0,165,13,152,45,8,37
33,Other,Female,White,Yes,1,10,0,10,2,0,2
33,Other,Male,Black,No,0,2562,233,2329,587,61,526
33,Other,Male,Black,No,1,165,14,151,49,3,46
33,Other,Male,Black,Yes,0,903,98,805,205,26,179
33,Other,Male,Black,Yes,1,30,7,23,9,1,8
33,Other,Male,Hispanic,No,0,652,60,592,144,16,128
33,Other,Male,Hispanic,No,1,973,122,851,183,34,149
33,Other,Male,Hispanic,Yes,0,280,50,230,62,17,45
33,Other,Male,Hispanic,Yes,1,569,71,498,98,11,87
33,Other,Male,Other,No,0,250,24,226,87,9,78
33,Other,Male,Other,No,1,251,8,243,35,0,35
33,Other,Male,Other,Yes,0,145,24,121,32,3,29
33,Other,Male,Other,Yes,1,5,3,2,1,0,1
33,Other,Male,White,No,0,816,58,758,206,17,189
33,Other,Male,White,No,1,35,7,28,12,2,10
33,Other,Male,White,Yes,0,441,52,389,99,8,91
33,Other,Male,White,Yes,1,20,7,13,7,2,5
34,Elementary,Female,Black,No,0,8158,656,7502,6221,492,5729
34,Elementary,Female,Black,No,1,1207,54,1153,1185,42,1143
34,Elementary,Female,Black,Yes,0,1520,130,1390,1113,94,1019
34,Elementary,Female,Black,Yes,1,50,1,49,28,0,28
34,Elementary,Female,Hispanic,No,0,1290,119,1171,1008,95,913
34,Elementary,Female,Hispanic,No,1,355,29,326,256,30,226
34,Elementary,Female,Hispanic,Yes,0,250,26,224,220,23,197
34,Elementary,Female,Hispanic,Yes,1,140,10,130,96,12,84
34,Elementary,Female,Other,No,0,1919,169,1750,1740,120,1620
34,Elementary,Female,Other,No,1,1444,52,1392,1148,46,1102
34,Elementary,Female,Other,Yes,0,305,32,273,292,32,260
34,Elementary,Female,Other,Yes,1,45,5,40,56,2,54
34,Elementary,Female,White,No,0,4058,293,3765,3028,193,2835
34,Elementary,Female,White,No,1,454,23,431,376,12,364
34,Elementary,Female,White,Yes,0,1100,105,995,788,56,732
34,Elementary,Female,White,Yes,1,30,0,30,16,0,16
34,Elementary,Male,Black,No,0,7487,517,6970,5904,419,5485
34,Elementary,Male,Black,No,1,1150,48,1102,1076,39,1037
34,Elementary,Male,Black,Yes,0,3197,300,2897,2568,223,2345
34,Elementary,Male,Black,Yes,1,155,4,151,104,9,95
34,Elementary,Male,Hispanic,No,0,1230,115,1115,996,87,909
34,Elementary,Male,Hispanic,No,1,389,35,354,328,22,306
34,Elementary,Male,Hispanic,Yes,0,435,39,396,432,64,368
34,Elementary,Male,Hispanic,Yes,1,180,33,147,116,18,98
34,Elementary,Male,Other,No,0,1757,132,1625,1577,135,1442
34,Elementary,Male,Other,No,1,1674,84,1590,1341,53,1288
34,Elementary,Male,Other,Yes,0,613,54,559,568,52,516
34,Elementary,Male,Other,Yes,1,105,14,91,76,9,67
34,Elementary,Male,White,No,0,3438,285,3153,2548,173,2375
34,Elementary,Male,White,No,1,507,40,467,448,31,417
34,Elementary,Male,White,Yes,0,1985,193,1792,1498,121,1377
34,Elementary,Male,White,Yes,1,50,6,44,44,0,44
34,High,Female,Black,No,0,3807,305,3502,2978,329,2649
34,High,Female,Black,No,1,600,29,571,696,28,668
34,High,Female,Black,Yes,0,775,68,707,606,76,530
34,High,Female,Black,Yes,1,80,6,74,52,1,51
34,High,Female,Hispanic,No,0,617,63,554,496,59,437
34,High,Female,Hispanic,No,1,372,58,314,348,91,257
34,High,Female,Hispanic,Yes,0,95,14,81,56,3,53
34,High,Female,Hispanic,Yes,1,95,10,85,68,6,62
34,High,Female,Other,No,0,375,41,334,300,25,275
34,High,Female,Other,No,1,915,40,875,791,50,741
34,High,Female,Other,Yes,0,50,2,48,40,6,34
34,High,Female,Other,Yes,1,20,2,18,28,3,25
34,High,Female,White,No,0,1815,184,1631,1472,146,1326
34,High,Female,White,No,1,200,11,189,171,8,163
34,High,Female,White,Yes,0,495,47,448,338,49,289
34,High,Male,Black,No,0,3109,227,2882,2347,203,2144
34,High,Male,Black,No,1,625,17,608,601,13,588
34,High,Male,Black,Yes,0,1308,163,1145,1037,135,902
34,High,Male,Black,Yes,1,60,2,58,68,5,63
34,High,Male,Hispanic,No,0,415,50,365,311,15,296
34,High,Male,Hispanic,No,1,415,39,376,312,25,287
34,High,Male,Hispanic,Yes,0,110,10,100,116,28,88
34,High,Male,Hispanic,Yes,1,170,32,138,152,24,128
34,High,Male,Other,No,0,265,24,241,252,12,240
34,High,Male,Other,No,1,950,65,885,743,51,692
34,High,Male,Other,Yes,0,145,17,128,100,4,96
34,High,Male,Other,Yes,1,35,1,34,28,4,24
34,High,Male,White,No,0,1449,90,1359,1167,87,1080
34,High,Male,White,No,1,270,24,246,207,28,179
34,High,Male,White,Yes,0,560,73,487,404,54,350
34,High,Male,White,Yes,1,5,1,4,4,0,4
34,Middle,Female,Black,No,0,2539,45,2494,2625,112,2513
34,Middle,Female,Black,No,1,397,2,395,492,7,485
34,Middle,Female,Black,Yes,0,471,16,455,440,22,418
34,Middle,Female,Black,Yes,1,40,1,39,40,1,39
34,Middle,Female,Hispanic,No,0,405,12,393,404,28,376
34,Middle,Female,Hispanic,No,1,249,5,244,212,10,202
34,Middle,Female,Hispanic,Yes,0,50,3,47,68,3,65
34,Middle,Female,Hispanic,Yes,1,45,0,45,64,8,56
34,Middle,Female,Other,No,0,310,12,298,288,15,273
34,Middle,Female,Other,No,1,520,4,516,492,10,482
34,Middle,Female,Other,Yes,0,70,1,69,48,13,35
34,Middle,Female,Other,Yes,1,10,0,10,4,0,4
34,Middle,Female,White,No,0,1443,29,1414,1218,59,1159
34,Middle,Female,White,No,1,150,1,149,152,6,146
34,Middle,Female,White,Yes,0,282,6,276,272,11,261
34,Middle,Female,White,Yes,1,5,0,5,4,0,4
34,Middle,Male,Black,No,0,2232,44,2188,2385,70,2315
34,Middle,Male,Black,No,1,358,3,355,507,9,498
34,Middle,Male,Black,Yes,0,1118,24,1094,1035,56,979
34,Middle,Male,Black,Yes,1,70,2,68,56,7,49
34,Middle,Male,Hispanic,No,0,321,7,314,400,15,385
34,Middle,Male,Hispanic,No,1,210,9,201,140,2,138
34,Middle,Male,Hispanic,Yes,0,185,4,181,164,18,146
34,Middle,Male,Hispanic,Yes,1,60,1,59,116,11,105
34,Middle,Male,Other,No,0,335,9,326,316,26,290
34,Middle,Male,Other,No,1,580,5,575,488,12,476
34,Middle,Male,Other,Yes,0,100,5,95,68,4,64
34,Middle,Male,Other,Yes,1,55,1,54,60,5,55
34,Middle,Male,White,No,0,1460,42,1418,1120,64,1056
34,Middle,Male,White,No,1,176,1,175,188,5,183
34,Middle,Male,White,Yes,0,605,17,588,626,54,572
34,Middle,Male,White,Yes,1,15,0,15,4,0,4
34,Other,Female,Black,No,0,2510,239,2271,2441,300,2141
34,Other,Female,Black,No,1,180,10,170,144,18,126
34,Other,Female,Black,Yes,0,344,64,280,388,74,314
34,Other,Female,Black,Yes,1,15,0,15,8,0,8
34,Other,Female,Hispanic,No,0,747,103,644,703,90,613
34,Other,Female,Hispanic,No,1,928,127,801,765,81,684
34,Other,Female,Hispanic,Yes,0,80,16,64,100,13,87
34,Other,Female,Hispanic,Yes,1,222,22,200,159,15,144
34,Other,Female,Other,No,0,320,43,277,422,39,383
34,Other,Female,Other,No,1,265,12,253,172,5,167
34,Other,Female,Other,Yes,0,40,5,35,44,5,39
34,Other,Female,Other,Yes,1,10,0,10,8,1,7
34,Other,Female,White,No,0,641,84,557,704,108,596
34,Other,Female,White,No,1,55,1,54,64,6,58
34,Other,Female,White,Yes,0,168,21,147,180,38,142
34,Other,Female,White,Yes,1,10,2,8,8,0,8
34,Other,Male,Black,No,0,2557,249,2308,2358,267,2091
34,Other,Male,Black,No,1,165,14,151,196,13,183
34,Other,Male,Black,Yes,0,905,118,787,819,119,700
34,Other,Male,Black,Yes,1,30,10,20,36,2,34
34,Other,Male,Hispanic,No,0,659,61,598,578,72,506
34,Other,Male,Hispanic,No,1,975,133,842,732,95,637
34,Other,Male,Hispanic,Yes,0,282,54,228,248,41,207
34,Other,Male,Hispanic,Yes,1,575,84,491,392,44,348
34,Other,Male,Other,No,0,257,22,235,348,22,326
34,Other,Male,Other,No,1,250,10,240,140,8,132
34,Other,Male,Other,Yes,0,143,29,114,128,15,113
34,Other,Male,Other,Yes,1,5,0,5,4,0,4
34,Other,Male,White,No,0,819,97,722,829,77,752
34,Other,Male,White,No,1,35,5,30,48,8,40
34,Other,Male,White,Yes,0,447,54,393,390,71,319
34,Other,Male,White,Yes,1,20,3,17,28,5,23
35,Elementary,Female,Black,No,0,8152,660,7492,7779,615,7164
35,Elementary,Female,Black,No,1,1203,70,1133,1490,71,1419
35,Elementary,Female,Black,Yes,0,1520,149,1371,1395,131,1264
35,Elementary,Female,Black,Yes,1,50,1,49,35,3,32
35,Elementary,Female,Hispanic,No,0,1289,107,1182,1260,122,1138
35,Elementary,Female,Hispanic,No,1,355,30,325,320,40,280
35,Elementary,Female,Hispanic,Yes,0,250,32,218,275,44,231
35,Elementary,Female,Hispanic,Yes,1,140,12,128,120,18,102
35,Elementary,Female,Other,No,0,1919,203,1716,2167,179,1988
35,Elementary,Female,Other,No,1,1445,68,1377,1435,60,1375
35,Elementary,Female,Other,Yes,0,305,25,280,365,31,334
35,Elementary,Female,Other,Yes,1,45,4,41,70,1,69
35,Elementary,Female,White,No,0,4057,290,3767,3789,262,3527
35,Elementary,Female,White,No,1,455,27,428,475,30,445
35,Elementary,Female,White,Yes,0,1100,86,1014,981,74,907
35,Elementary,Female,White,Yes,1,30,2,28,20,0,20
35,Elementary,Male,Black,No,0,7483,544,6939,7388,577,6811
35,Elementary,Male,Black,No,1,1146,55,1091,1343,50,1293
35,Elementary,Male,Black,Yes,0,3194,329,2865,3214,292,2922
35,Elementary,Male,Black,Yes,1,155,5,150,130,11,119
35,Elementary,Male,Hispanic,No,0,1230,127,1103,1247,100,1147
35,Elementary,Male,Hispanic,No,1,390,38,352,414,30,384
35,Elementary,Male,Hispanic,Yes,0,435,40,395,541,73,468
35,Elementary,Male,Hispanic,Yes,1,177,31,146,143,28,115
35,Elementary,Male,Other,No,0,1758,134,1624,1966,184,1782
35,Elementary,Male,Other,No,1,1676,86,1590,1679,56,1623
35,Elementary,Male,Other,Yes,0,620,42,578,710,55,655
35,Elementary,Male,Other,Yes,1,105,11,94,95,12,83
35,Elementary,Male,White,No,0,3429,261,3168,3181,226,2955
35,Elementary,Male,White,No,1,510,37,473,562,37,525
35,Elementary,Male,White,Yes,0,1983,167,1816,1877,161,1716
35,Elementary,Male,White,Yes,1,50,2,48,55,5,50
35,High,Female,Black,No,0,3796,370,3426,3718,418,3300
35,High,Female,Black,No,1,600,34,566,866,42,824
35,High,Female,Black,Yes,0,770,73,697,755,108,647
35,High,Female,Black,Yes,1,80,5,75,65,4,61
35,High,Female,Hispanic,No,0,618,68,550,621,89,532
35,High,Female,Hispanic,No,1,366,55,311,434,102,332
35,High,Female,Hispanic,Yes,0,95,7,88,70,8,62
35,High,Female,Hispanic,Yes,1,95,16,79,85,4,81
35,High,Female,Other,No,0,375,45,330,375,40,335
35,High,Female,Other,No,1,913,47,866,983,62,921
35,High,Female,Other,Yes,0,50,5,45,50,3,47
35,High,Female,Other,Yes,1,20,3,17,35,5,30
35,High,Female,White,No,0,1815,188,1627,1832,201,1631
35,High,Female,White,No,1,200,5,195,210,12,198
35,High,Female,White,Yes,0,490,50,440,422,56,366
35,High,Male,Black,No,0,3103,247,2856,2907,236,2671
35,High,Male,Black,No,1,628,28,600,748,28,720
35,High,Male,Black,Yes,0,1300,152,1148,1289,184,1105
35,High,Male,Black,Yes,1,60,6,54,85,9,76
35,High,Male,Hispanic,No,0,411,47,364,385,30,355
35,High,Male,Hispanic,No,1,415,38,377,390,27,363
35,High,Male,Hispanic,Yes,0,110,15,95,145,25,120
35,High,Male,Hispanic,Yes,1,168,28,140,185,27,158
35,High,Male,Other,No,0,265,21,244,315,23,292
35,High,Male,Other,No,1,943,63,880,917,60,857
35,High,Male,Other,Yes,0,145,8,137,125,11,114
35,High,Male,Other,Yes,1,35,0,35,35,3,32
35,High,Male,White,No,0,1450,125,1325,1455,120,1335
35,High,Male,White,No,1,270,31,239,252,31,221
35,High,Male,White,Yes,0,559,63,496,500,53,447
35,High,Male,White,Yes,1,5,1,4,5,0,5
35,Middle,Female,Black,No,0,2545,42,2503,3285,133,3152
35,Middle,Female,Black,No,1,400,8,392,619,8,611
35,Middle,Female,Black,Yes,0,475,15,460,550,44,506
35,Middle,Female,Black,Yes,1,40,0,40,50,0,50
35,Middle,Female,Hispanic,No,0,400,8,392,505,29,476
35,Middle,Female,Hispanic,No,1,248,11,237,265,10,255
35,Middle,Female,Hispanic,Yes,0,50,2,48,85,5,80
35,Middle,Female,Hispanic,Yes,1,45,2,43,80,11,69
35,Middle,Female,Other,No,0,310,5,305,360,17,343
35,Middle,Female,Other,No,1,520,7,513,614,8,606
35,Middle,Female,Other,Yes,0,70,4,66,60,16,44
35,Middle,Female,Other,Yes,1,10,1,9,5,0,5
35,Middle,Female,White,No,0,1443,41,1402,1528,84,1444
35,Middle,Female,White,No,1,150,2,148,190,11,179
35,Middle,Female,White,Yes,0,280,5,275,340,22,318
35,Middle,Female,White,Yes,1,5,0,5,5,0,5
35,Middle,Male,Black,No,0,2230,33,2197,2984,62,2922
35,Middle,Male,Black,No,1,360,1,359,637,6,631
35,Middle,Male,Black,Yes,0,1120,39,1081,1294,56,1238
35,Middle,Male,Black,Yes,1,70,1,69,70,2,68
35,Middle,Male,Hispanic,No,0,325,7,318,500,25,475
35,Middle,Male,Hispanic,No,1,210,2,208,178,2,176
35,Middle,Male,Hispanic,Yes,0,185,5,180,205,19,186
35,Middle,Male,Hispanic,Yes,1,60,3,57,145,11,134
35,Middle,Male,Other,No,0,335,11,324,395,38,357
35,Middle,Male,Other,No,1,580,9,571,610,16,594
35,Middle,Male,Other,Yes,0,100,4,96,85,7,78
35,Middle,Male,Other,Yes,1,55,3,52,75,7,68
35,Middle,Male,White,No,0,1455,42,1413,1403,63,1340
35,Middle,Male,White,No,1,180,5,175,235,6,229
35,Middle,Male,White,Yes,0,605,27,578,777,79,698
35,Middle,Male,White,Yes,1,15,0,15,5,0,5
35,Other,Female,Black,No,0,2528,266,2262,3069,445,2624
35,Other,Female,Black,No,1,180,7,173,180,25,155
35,Other,Female,Black,Yes,0,344,58,286,497,89,408
35,Other,Female,Black,Yes,1,15,0,15,10,0,10
35,Other,Female,Hispanic,No,0,751,103,648,871,113,758
35,Other,Female,Hispanic,No,1,929,131,798,965,129,836
35,Other,Female,Hispanic,Yes,0,80,4,76,129,17,112
35,Other,Female,Hispanic,Yes,1,225,27,198,195,14,181
35,Other,Female,Other,No,0,320,39,281,528,51,477
35,Other,Female,Other,No,1,265,11,254,215,9,206
35,Other,Female,Other,Yes,0,40,6,34,55,3,52
35,Other,Female,Other,Yes,1,10,0,10,10,0,10
35,Other,Female,White,No,0,646,67,579,886,145,741
35,Other,Female,White,No,1,55,4,51,80,8,72
35,Other,Female,White,Yes,0,170,15,155,223,37,186
35,Other,Female,White,Yes,1,10,2,8,10,2,8
35,Other,Male,Black,No,0,2565,246,2319,2997,393,2604
35,Other,Male,Black,No,1,163,13,150,247,19,228
35,Other,Male,Black,Yes,0,913,97,816,1017,151,866
35,Other,Male,Black,Yes,1,30,4,26,41,5,36
35,Other,Male,Hispanic,No,0,660,66,594,725,99,626
35,Other,Male,Hispanic,No,1,972,145,827,925,123,802
35,Other,Male,Hispanic,Yes,0,283,56,227,310,63,247
35,Other,Male,Hispanic,Yes,1,574,84,490,490,63,427
35,Other,Male,Other,No,0,260,33,227,438,37,401
35,Other,Male,Other,No,1,250,13,237,175,14,161
35,Other,Male,Other,Yes,0,140,25,115,165,30,135
35,Other,Male,Other,Yes,1,5,1,4,5,0,5
35,Other,Male,White,No,0,809,70,739,1027,97,930
35,Other,Male,White,No,1,35,5,30,60,9,51
35,Other,Male,White,Yes,0,449,48,401,483,78,405
35,Other,Male,White,Yes,1,20,2,18,35,8,27
36,Elementary,Female,Black,No,0,8142,643,7499,7784,677,7107
36,Elementary,Female,Black,No,1,1200,82,1118,1490,77,1413
36,Elementary,Female,Black,Yes,0,1520,138,1382,1395,128,1267
36,Elementary,Female,Black,Yes,1,50,0,50,35,0,35
36,Elementary,Female,Hispanic,No,0,1285,116,1169,1260,155,1105
36,Elementary,Female,Hispanic,No,1,355,40,315,320,38,282
36,Elementary,Female,Hispanic,Yes,0,250,28,222,275,45,230
36,Elementary,Female,Hispanic,Yes,1,140,8,132,120,11,109
36,Elementary,Female,Other,No,0,1915,203,1712,2169,154,2015
36,Elementary,Female,Other,No,1,1445,58,1387,1435,61,1374
36,Elementary,Female,Other,Yes,0,305,33,272,362,33,329
36,Elementary,Female,Other,Yes,1,45,8,37,70,7,63
36,Elementary,Female,White,No,0,4055,304,3751,3794,300,3494
36,Elementary,Female,White,No,1,455,41,414,475,30,445
36,Elementary,Female,White,Yes,0,1100,97,1003,980,84,896
36,Elementary,Female,White,Yes,1,30,0,30,20,1,19
36,Elementary,Male,Black,No,0,7474,564,6910,7404,608,6796
36,Elementary,Male,Black,No,1,1144,73,1071,1340,67,1273
36,Elementary,Male,Black,Yes,0,3190,276,2914,3220,293,2927
36,Elementary,Male,Black,Yes,1,155,17,138,130,16,114
36,Elementary,Male,Hispanic,No,0,1230,92,1138,1251,110,1141
36,Elementary,Male,Hispanic,No,1,390,49,341,415,29,386
36,Elementary,Male,Hispanic,Yes,0,435,46,389,545,62,483
36,Elementary,Male,Hispanic,Yes,1,175,23,152,140,21,119
36,Elementary,Male,Other,No,0,1750,157,1593,1960,166,1794
36,Elementary,Male,Other,No,1,1680,87,1593,1685,72,1613
36,Elementary,Male,Other,Yes,0,620,65,555,710,61,649
36,Elementary,Male,Other,Yes,1,105,6,99,95,7,88
36,Elementary,Male,White,No,0,3422,265,3157,3188,241,2947
36,Elementary,Male,White,No,1,510,43,467,570,51,519
36,Elementary,Male,White,Yes,0,1982,175,1807,1881,203,1678
36,Elementary,Male,White,Yes,1,50,6,44,55,6,49
36,High,Female,Black,No,0,3790,300,3490,3719,353,3366
36,High,Female,Black,No,1,600,35,565,865,35,830
36,High,Female,Black,Yes,0,775,72,703,756,107,649
36,High,Female,Black,Yes,1,80,5,75,65,2,63
36,High,Female,Hispanic,No,0,617,51,566,625,73,552
36,High,Female,Hispanic,No,1,365,51,314,433,94,339
36,High,Female,Hispanic,Yes,0,95,7,88,70,10,60
36,High,Female,Hispanic,Yes,1,95,9,86,85,7,78
36,High,Female,Other,No,0,372,40,332,375,33,342
36,High,Female,Other,No,1,912,51,861,981,50,931
36,High,Female,Other,Yes,0,50,4,46,50,8,42
36,High,Female,Other,Yes,1,20,3,17,35,0,35
36,High,Female,White,No,0,1815,194,1621,1829,205,1624
36,High,Female,White,No,1,200,11,189,210,12,198
36,High,Female,White,Yes,0,487,69,418,421,75,346
36,High,Male,Black,No,0,3090,245,2845,2900,284,2616
36,High,Male,Black,No,1,630,24,606,750,19,731
36,High,Male,Black,Yes,0,1300,167,1133,1277,174,1103
36,High,Male,Black,Yes,1,60,2,58,85,6,79
36,High,Male,Hispanic,No,0,405,42,363,385,21,364
36,High,Male,Hispanic,No,1,414,54,360,390,43,347
36,High,Male,Hispanic,Yes,0,110,7,103,145,26,119
36,High,Male,Hispanic,Yes,1,165,26,139,185,26,159
36,High,Male,Other,No,0,265,19,246,315,18,297
36,High,Male,Other,No,1,935,84,851,915,59,856
36,High,Male,Other,Yes,0,145,17,128,125,10,115
36,High,Male,Other,Yes,1,35,2,33,35,4,31
36,High,Male,White,No,0,1450,113,1337,1455,95,1360
36,High,Male,White,No,1,272,36,236,250,22,228
36,High,Male,White,Yes,0,555,76,479,500,53,447
36,High,Male,White,Yes,1,5,1,4,5,0,5
36,Middle,Female,Black,No,0,2540,35,2505,3287,151,3136
36,Middle,Female,Black,No,1,400,0,400,623,7,616
36,Middle,Female,Black,Yes,0,475,7,468,550,36,514
36,Middle,Female,Black,Yes,1,40,1,39,50,1,49
36,Middle,Female,Hispanic,No,0,395,13,382,505,31,474
36,Middle,Female,Hispanic,No,1,245,5,240,265,7,258
36,Middle,Female,Hispanic,Yes,0,50,0,50,85,9,76
36,Middle,Female,Hispanic,Yes,1,45,0,45,80,12,68
36,Middle,Female,Other,No,0,310,6,304,360,26,334
36,Middle,Female,Other,No,1,520,3,517,610,7,603
36,Middle,Female,Other,Yes,0,70,2,68,60,17,43
36,Middle,Female,Other,Yes,1,10,0,10,5,0,5
36,Middle,Female,White,No,0,1440,30,1410,1525,77,1448
36,Middle,Female,White,No,1,152,2,150,190,10,180
36,Middle,Female,White,Yes,0,280,11,269,340,16,324
36,Middle,Female,White,Yes,1,5,0,5,5,0,5
36,Middle,Male,Black,No,0,2226,33,2193,2985,82,2903
36,Middle,Male,Black,No,1,360,1,359,644,11,633
36,Middle,Male,Black,Yes,0,1120,31,1089,1290,62,1228
36,Middle,Male,Black,Yes,1,70,1,69,70,3,67
36,Middle,Male,Hispanic,No,0,325,8,317,500,33,467
36,Middle,Male,Hispanic,No,1,210,3,207,180,4,176
36,Middle,Male,Hispanic,Yes,0,181,2,179,205,15,190
36,Middle,Male,Hispanic,Yes,1,60,1,59,145,3,142
36,Middle,Male,Other,No,0,335,10,325,395,36,359
36,Middle,Male,Other,No,1,584,3,581,610,6,604
36,Middle,Male,Other,Yes,0,100,4,96,85,9,76
36,Middle,Male,Other,Yes,1,55,3,52,75,8,67
36,Middle,Male,White,No,0,1455,40,1415,1405,60,1345
36,Middle,Male,White,No,1,180,0,180,235,9,226
36,Middle,Male,White,Yes,0,605,18,587,775,61,714
36,Middle,Male,White,Yes,1,15,0,15,5,0,5
36,Other,Female,Black,No,0,2523,232,2291,3057,485,2572
36,Other,Female,Black,No,1,179,9,170,180,24,156
36,Other,Female,Black,Yes,0,332,51,281,501,112,389
36,Other,Female,Black,Yes,1,15,0,15,10,1,9
36,Other,Female,Hispanic,No,0,752,86,666,871,134,737
36,Other,Female,Hispanic,No,1,925,112,813,966,132,834
36,Other,Female,Hispanic,Yes,0,80,5,75,130,16,114
36,Other,Female,Hispanic,Yes,1,225,41,184,195,21,174
36,Other,Female,Other,No,0,324,42,282,528,61,467
36,Other,Female,Other,No,1,265,10,255,215,9,206
36,Other,Female,Other,Yes,0,40,9,31,55,4,51
36,Other,Female,Other,Yes,1,10,0,10,10,0,10
36,Other,Female,White,No,0,637,57,580,893,146,747
36,Other,Female,White,No,1,55,3,52,80,7,73
36,Other,Female,White,Yes,0,170,17,153,220,39,181
36,Other,Female,White,Yes,1,10,4,6,10,2,8
36,Other,Male,Black,No,0,2565,230,2335,2989,393,2596
36,Other,Male,Black,No,1,160,12,148,245,21,224
36,Other,Male,Black,Yes,0,922,139,783,1018,156,862
36,Other,Male,Black,Yes,1,30,5,25,40,6,34
36,Other,Male,Hispanic,No,0,660,72,588,725,91,634
36,Other,Male,Hispanic,No,1,969,153,816,925,139,786
36,Other,Male,Hispanic,Yes,0,280,43,237,310,65,245
36,Other,Male,Hispanic,Yes,1,570,68,502,490,65,425
36,Other,Male,Other,No,0,260,37,223,435,29,406
36,Other,Male,Other,No,1,254,14,240,175,13,162
36,Other,Male,Other,Yes,0,140,29,111,165,34,131
36,Other,Male,Other,Yes,1,5,2,3,5,0,5
36,Other,Male,White,No,0,793,79,714,1021,119,902
36,Other,Male,White,No,1,35,5,30,60,14,46
36,Other,Male,White,Yes,0,446,54,392,475,78,397
36,Other,Male,White,Yes,1,20,3,17,35,6,29
37,Elementary,Female,Black,No,0,6508,538,5970,7782,623,7159
37,Elementary,Female,Black,No,1,947,49,898,1494,71,1423
37,Elementary,Female,Black,Yes,0,1216,137,1079,1395,130,1265
37,Elementary,Female,Black,Yes,1,40,4,36,35,0,35
37,Elementary,Female,Hispanic,No,0,1028,106,922,1260,135,1125
37,Elementary,Female,Hispanic,No,1,284,27,257,320,40,280
37,Elementary,Female,Hispanic,Yes,0,200,19,181,275,42,233
37,Elementary,Female,Hispanic,Yes,1,112,8,104,120,9,111
37,Elementary,Female,Other,No,0,1532,146,1386,2171,164,2007
37,Elementary,Female,Other,No,1,1156,58,1098,1446,72,1374
37,Elementary,Female,Other,Yes,0,244,26,218,360,21,339
37,Elementary,Female,Other,Yes,1,36,4,32,70,5,65
37,Elementary,Female,White,No,0,3245,255,2990,3799,306,3493
37,Elementary,Female,White,No,1,367,22,345,475,29,446
37,Elementary,Female,White,Yes,0,880,68,812,980,100,880
37,Elementary,Female,White,Yes,1,24,0,24,20,0,20
37,Elementary,Male,Black,No,0,5976,550,5426,7415,578,6837
37,Elementary,Male,Black,No,1,919,52,867,1344,59,1285
37,Elementary,Male,Black,Yes,0,2552,271,2281,3220,320,2900
37,Elementary,Male,Black,Yes,1,120,8,112,130,14,116
37,Elementary,Male,Hispanic,No,0,984,107,877,1255,109,1146
37,Elementary,Male,Hispanic,No,1,312,27,285,415,25,390
37,Elementary,Male,Hispanic,Yes,0,348,38,310,550,77,473
37,Elementary,Male,Hispanic,Yes,1,140,20,120,140,32,108
37,Elementary,Male,Other,No,0,1400,127,1273,1963,184,1779
37,Elementary,Male,Other,No,1,1344,74,1270,1685,71,1614
37,Elementary,Male,Other,Yes,0,498,44,454,710,65,645
37,Elementary,Male,Other,Yes,1,84,8,76,95,17,78
37,Elementary,Male,White,No,0,2735,216,2519,3186,242,2944
37,Elementary,Male,White,No,1,408,41,367,570,45,525
37,Elementary,Male,White,Yes,0,1591,161,1430,1885,160,1725
37,Elementary,Male,White,Yes,1,40,1,39,55,9,46
37,High,Female,Black,No,0,3029,290,2739,3713,356,3357
37,High,Female,Black,No,1,479,36,443,866,39,827
37,High,Female,Black,Yes,0,620,64,556,758,93,665
37,High,Female,Black,Yes,1,60,4,56,65,1,64
37,High,Female,Hispanic,No,0,494,44,450,625,70,555
37,High,Female,Hispanic,No,1,292,42,250,429,74,355
37,High,Female,Hispanic,Yes,0,76,13,63,70,6,64
37,High,Female,Hispanic,Yes,1,76,6,70,85,8,77
37,High,Female,Other,No,0,296,42,254,375,33,342
37,High,Female,Other,No,1,731,52,679,978,52,926
37,High,Female,Other,Yes,0,40,2,38,50,6,44
37,High,Female,Other,Yes,1,16,5,11,37,1,36
37,High,Female,White,No,0,1450,164,1286,1823,145,1678
37,High,Female,White,No,1,160,10,150,210,18,192
37,High,Female,White,Yes,0,385,49,336,421,71,350
37,High,Male,Black,No,0,2457,201,2256,2902,266,2636
37,High,Male,Black,No,1,503,19,484,750,28,722
37,High,Male,Black,Yes,0,1040,133,907,1263,183,1080
37,High,Male,Black,Yes,1,48,6,42,85,8,77
37,High,Male,Hispanic,No,0,324,38,286,385,19,366
37,High,Male,Hispanic,No,1,327,46,281,395,44,351
37,High,Male,Hispanic,Yes,0,88,12,76,145,25,120
37,High,Male,Hispanic,Yes,1,132,23,109,185,22,163
37,High,Male,Other,No,0,208,15,193,314,19,295
37,High,Male,Other,No,1,748,78,670,915,74,841
37,High,Male,Other,Yes,0,116,15,101,125,6,119
37,High,Male,Other,Yes,1,28,1,27,35,3,32
37,High,Male,White,No,0,1160,91,1069,1455,105,1350
37,High,Male,White,No,1,211,21,190,250,21,229
37,High,Male,White,Yes,0,440,55,385,500,65,435
37,High,Male,White,Yes,1,4,3,1,5,0,5
37,Middle,Female,Black,No,0,2031,41,1990,3271,89,3182
37,Middle,Female,Black,No,1,320,7,313,625,6,619
37,Middle,Female,Black,Yes,0,380,10,370,550,31,519
37,Middle,Female,Black,Yes,1,32,0,32,50,0,50
37,Middle,Female,Hispanic,No,0,316,7,309,504,15,489
37,Middle,Female,Hispanic,No,1,196,4,192,265,5,260
37,Middle,Female,Hispanic,Yes,0,40,1,39,85,6,79
37,Middle,Female,Hispanic,Yes,1,36,1,35,80,8,72
37,Middle,Female,Other,No,0,244,1,243,360,16,344
37,Middle,Female,Other,No,1,416,8,408,614,13,601
37,Middle,Female,Other,Yes,0,56,2,54,60,15,45
37,Middle,Female,Other,Yes,1,8,1,7,5,0,5
37,Middle,Female,White,No,0,1152,32,1120,1520,60,1460
37,Middle,Female,White,No,1,124,2,122,195,7,188
37,Middle,Female,White,Yes,0,224,14,210,340,13,327
37,Middle,Female,White,Yes,1,4,0,4,5,0,5
37,Middle,Male,Black,No,0,1780,42,1738,2959,61,2898
37,Middle,Male,Black,No,1,288,1,287,647,10,637
37,Middle,Male,Black,Yes,0,896,28,868,1287,50,1237
37,Middle,Male,Black,Yes,1,56,0,56,70,2,68
37,Middle,Male,Hispanic,No,0,260,6,254,496,18,478
37,Middle,Male,Hispanic,No,1,168,4,164,181,2,179
37,Middle,Male,Hispanic,Yes,0,144,4,140,205,17,188
37,Middle,Male,Hispanic,Yes,1,48,2,46,145,13,132
37,Middle,Male,Other,No,0,266,11,255,393,18,375
37,Middle,Male,Other,No,1,468,2,466,609,9,600
37,Middle,Male,Other,Yes,0,80,3,77,84,3,81
37,Middle,Male,Other,Yes,1,44,0,44,75,8,67
37,Middle,Male,White,No,0,1165,44,1121,1397,49,1348
37,Middle,Male,White,No,1,144,4,140,234,6,228
37,Middle,Male,White,Yes,0,484,25,459,774,53,721
37,Middle,Male,White,Yes,1,12,0,12,5,0,5
37,Other,Female,Black,No,0,2024,206,1818,3061,442,2619
37,Other,Female,Black,No,1,140,7,133,180,25,155
37,Other,Female,Black,Yes,0,260,35,225,504,85,419
37,Other,Female,Black,Yes,1,12,0,12,10,0,10
37,Other,Female,Hispanic,No,0,600,100,500,877,88,789
37,Other,Female,Hispanic,No,1,740,109,631,973,111,862
37,Other,Female,Hispanic,Yes,0,66,10,56,133,16,117
37,Other,Female,Hispanic,Yes,1,180,24,156,195,16,179
37,Other,Female,Other,No,0,260,38,222,525,56,469
37,Other,Female,Other,No,1,212,6,206,215,3,212
37,Other,Female,Other,Yes,0,32,5,27,55,5,50
37,Other,Female,Other,Yes,1,8,0,8,10,0,10
37,Other,Female,White,No,0,510,60,450,894,126,768
37,Other,Female,White,No,1,47,0,47,80,13,67
37,Other,Female,White,Yes,0,136,17,119,220,34,186
37,Other,Female,White,Yes,1,8,3,5,10,3,7
37,Other,Male,Black,No,0,2057,213,1844,2994,373,2621
37,Other,Male,Black,No,1,128,8,120,245,20,225
37,Other,Male,Black,Yes,0,743,100,643,1022,159,863
37,Other,Male,Black,Yes,1,24,6,18,40,1,39
37,Other,Male,Hispanic,No,0,526,62,464,725,87,638
37,Other,Male,Hispanic,No,1,776,125,651,924,104,820
37,Other,Male,Hispanic,Yes,0,224,43,181,313,70,243
37,Other,Male,Hispanic,Yes,1,456,56,400,490,65,425
37,Other,Male,Other,No,0,208,21,187,435,26,409
37,Other,Male,Other,No,1,204,15,189,175,7,168
37,Other,Male,Other,Yes,0,112,22,90,165,26,139
37,Other,Male,Other,Yes,1,4,1,3,5,0,5
37,Other,Male,White,No,0,633,59,574,1027,100,927
37,Other,Male,White,No,1,28,4,24,60,12,48
37,Other,Male,White,Yes,0,362,51,311,473,65,408
37,Other,Male,White,Yes,1,16,2,14,35,5,30
38,Elementary,Female,Black,No,0,8123,582,7541,3112,345,2767
38,Elementary,Female,Black,No,1,1190,67,1123,602,25,577
38,Elementary,Female,Black,Yes,0,1520,134,1386,558,61,497
38,Elementary,Female,Black,Yes,1,50,3,47,14,0,14
38,Elementary,Female,Hispanic,No,0,1283,116,1167,504,56,448
38,Elementary,Female,Hispanic,No,1,355,33,322,128,15,113
38,Elementary,Female,Hispanic,Yes,0,250,27,223,110,21,89
38,Elementary,Female,Hispanic,Yes,1,140,18,122,48,6,42
38,Elementary,Female,Other,No,0,1915,198,1717,870,85,785
38,Elementary,Female,Other,No,1,1448,61,1387,580,38,542
38,Elementary,Female,Other,Yes,0,305,25,280,144,23,121
38,Elementary,Female,Other,Yes,1,45,3,42,28,4,24
38,Elementary,Female,White,No,0,4047,283,3764,1518,128,1390
38,Elementary,Female,White,No,1,467,48,419,190,14,176
38,Elementary,Female,White,Yes,0,1100,84,1016,392,34,358
38,Elementary,Female,White,Yes,1,30,0,30,8,0,8
38,Elementary,Male,Black,No,0,7466,562,6904,2969,276,2693
38,Elementary,Male,Black,No,1,1153,52,1101,544,18,526
38,Elementary,Male,Black,Yes,0,3181,296,2885,1288,123,1165
38,Elementary,Male,Black,Yes,1,150,8,142,52,7,45
38,Elementary,Male,Hispanic,No,0,1228,117,1111,502,48,454
38,Elementary,Male,Hispanic,No,1,390,50,340,166,13,153
38,Elementary,Male,Hispanic,Yes,0,435,37,398,222,21,201
38,Elementary,Male,Hispanic,Yes,1,175,26,149,56,9,47
38,Elementary,Male,Other,No,0,1745,146,1599,788,104,684
38,Elementary,Male,Other,No,1,1683,76,1607,674,26,648
38,Elementary,Male,Other,Yes,0,625,68,557,284,34,250
38,Elementary,Male,Other,Yes,1,105,8,97,38,7,31
38,Elementary,Male,White,No,0,3411,269,3142,1274,108,1166
38,Elementary,Male,White,No,1,514,46,468,228,19,209
38,Elementary,Male,White,Yes,0,1990,182,1808,754,85,669
38,Elementary,Male,White,Yes,1,50,4,46,22,3,19
38,High,Female,Black,No,0,3790,366,3424,1482,169,1313
38,High,Female,Black,No,1,604,41,563,348,13,335
38,High,Female,Black,Yes,0,775,78,697,302,37,265
38,High,Female,Black,Yes,1,75,7,68,26,1,25
38,High,Female,Hispanic,No,0,618,63,555,250,39,211
38,High,Female,Hispanic,No,1,365,64,301,172,40,132
38,High,Female,Hispanic,Yes,0,95,17,78,28,7,21
38,High,Female,Hispanic,Yes,1,95,11,84,34,2,32
38,High,Female,Other,No,0,370,58,312,150,12,138
38,High,Female,Other,No,1,915,51,864,393,28,365
38,High,Female,Other,Yes,0,50,5,45,20,4,16
38,High,Female,Other,Yes,1,20,6,14,18,1,17
38,High,Female,White,No,0,1810,197,1613,729,64,665
38,High,Female,White,No,1,200,10,190,84,7,77
38,High,Female,White,Yes,0,479,55,424,165,35,130
38,High,Male,Black,No,0,3071,255,2816,1162,115,1047
38,High,Male,Black,No,1,630,30,600,300,7,293
38,High,Male,Black,Yes,0,1300,167,1133,505,79,426
38,High,Male,Black,Yes,1,60,8,52,34,3,31
38,High,Male,Hispanic,No,0,405,60,345,153,9,144
38,High,Male,Hispanic,No,1,408,58,350,160,16,144
38,High,Male,Hispanic,Yes,0,110,16,94,58,14,44
38,High,Male,Hispanic,Yes,1,165,29,136,74,12,62
38,High,Male,Other,No,0,260,18,242,124,8,116
38,High,Male,Other,No,1,937,67,870,366,37,329
38,High,Male,Other,Yes,0,145,14,131,50,1,49
38,High,Male,Other,Yes,1,35,1,34,14,0,14
38,High,Male,White,No,0,1448,131,1317,582,42,540
38,High,Male,White,No,1,260,20,240,100,11,89
38,High,Male,White,Yes,0,550,67,483,200,32,168
38,High,Male,White,Yes,1,5,2,3,2,0,2
38,Middle,Female,Black,No,0,2535,51,2484,1297,42,1255
38,Middle,Female,Black,No,1,400,7,393,250,4,246
38,Middle,Female,Black,Yes,0,475,13,462,220,13,207
38,Middle,Female,Black,Yes,1,40,0,40,20,0,20
38,Middle,Female,Hispanic,No,0,395,13,382,201,9,192
38,Middle,Female,Hispanic,No,1,245,6,239,106,3,103
38,Middle,Female,Hispanic,Yes,0,50,2,48,34,0,34
38,Middle,Female,Hispanic,Yes,1,45,2,43,32,4,28
38,Middle,Female,Other,No,0,300,2,298,144,7,137
38,Middle,Female,Other,No,1,520,7,513,250,3,247
38,Middle,Female,Other,Yes,0,70,4,66,24,4,20
38,Middle,Female,Other,Yes,1,10,1,9,2,0,2
38,Middle,Female,White,No,0,1446,23,1423,605,27,578
38,Middle,Female,White,No,1,155,2,153,78,4,74
38,Middle,Female,White,Yes,0,280,13,267,136,6,130
38,Middle,Female,White,Yes,1,5,0,5,2,0,2
38,Middle,Male,Black,No,0,2226,32,2194,1168,31,1137
38,Middle,Male,Black,No,1,363,3,360,260,2,258
38,Middle,Male,Black,Yes,0,1120,23,1097,513,27,486
38,Middle,Male,Black,Yes,1,70,0,70,28,1,27
38,Middle,Male,Hispanic,No,0,325,5,320,196,4,192
38,Middle,Male,Hispanic,No,1,210,6,204,73,2,71
38,Middle,Male,Hispanic,Yes,0,180,4,176,82,6,76
38,Middle,Male,Hispanic,Yes,1,60,0,60,58,9,49
38,Middle,Male,Other,No,0,330,8,322,156,11,145
38,Middle,Male,Other,No,1,585,1,584,244,6,238
38,Middle,Male,Other,Yes,0,100,6,94,33,4,29
38,Middle,Male,Other,Yes,1,55,0,55,30,4,26
38,Middle,Male,White,No,0,1458,39,1419,554,18,536
38,Middle,Male,White,No,1,180,1,179,92,2,90
38,Middle,Male,White,Yes,0,604,12,592,309,19,290
38,Middle,Male,White,Yes,1,15,0,15,2,0,2
38,Other,Female,Black,No,0,2522,268,2254,1225,208,1017
38,Other,Female,Black,No,1,175,8,167,72,6,66
38,Other,Female,Black,Yes,0,325,46,279,203,34,169
38,Other,Female,Black,Yes,1,15,1,14,4,0,4
38,Other,Female,Hispanic,No,0,747,116,631,351,50,301
38,Other,Female,Hispanic,No,1,925,137,788,390,58,332
38,Other,Female,Hispanic,Yes,0,85,8,77,54,5,49
38,Other,Female,Hispanic,Yes,1,225,30,195,78,7,71
38,Other,Female,Other,No,0,320,39,281,209,26,183
38,Other,Female,Other,No,1,265,11,254,86,4,82
38,Other,Female,Other,Yes,0,40,2,38,22,3,19
38,Other,Female,Other,Yes,1,10,0,10,4,0,4
38,Other,Female,White,No,0,637,60,577,357,57,300
38,Other,Female,White,No,1,60,4,56,32,6,26
38,Other,Female,White,Yes,0,169,20,149,88,17,71
38,Other,Female,White,Yes,1,10,2,8,4,0,4
38,Other,Male,Black,No,0,2574,265,2309,1200,183,1017
38,Other,Male,Black,No,1,160,7,153,98,11,87
38,Other,Male,Black,Yes,0,926,135,791,409,70,339
38,Other,Male,Black,Yes,1,30,4,26,16,1,15
38,Other,Male,Hispanic,No,0,655,82,573,290,39,251
38,Other,Male,Hispanic,No,1,970,159,811,368,50,318
38,Other,Male,Hispanic,Yes,0,280,52,228,126,29,97
38,Other,Male,Hispanic,Yes,1,567,83,484,196,30,166
38,Other,Male,Other,No,0,260,28,232,174,16,158
38,Other,Male,Other,No,1,260,16,244,70,3,67
38,Other,Male,Other,Yes,0,140,29,111,66,11,55
38,Other,Male,Other,Yes,1,5,1,4,2,0,2
38,Other,Male,White,No,0,801,78,723,411,54,357
38,Other,Male,White,No,1,39,6,33,24,6,18
38,Other,Male,White,Yes,0,455,64,391,190,26,164
38,Other,Male,White,Yes,1,20,5,15,14,4,10
39,Elementary,Female,Black,No,0,8125,704,7421,NA,NA,NA
39,Elementary,Female,Black,No,1,1197,86,1111,NA,NA,NA
39,Elementary,Female,Black,Yes,0,1520,154,1366,NA,NA,NA
39,Elementary,Female,Black,Yes,1,50,6,44,NA,NA,NA
39,Elementary,Female,Hispanic,No,0,1285,131,1154,NA,NA,NA
39,Elementary,Female,Hispanic,No,1,355,48,307,NA,NA,NA
39,Elementary,Female,Hispanic,Yes,0,250,38,212,NA,NA,NA
39,Elementary,Female,Hispanic,Yes,1,140,13,127,NA,NA,NA
39,Elementary,Female,Other,No,0,1915,180,1735,NA,NA,NA
39,Elementary,Female,Other,No,1,1445,51,1394,NA,NA,NA
39,Elementary,Female,Other,Yes,0,305,25,280,NA,NA,NA
39,Elementary,Female,Other,Yes,1,45,6,39,NA,NA,NA
39,Elementary,Female,White,No,0,4044,312,3732,NA,NA,NA
39,Elementary,Female,White,No,1,470,36,434,NA,NA,NA
39,Elementary,Female,White,Yes,0,1096,84,1012,NA,NA,NA
39,Elementary,Female,White,Yes,1,30,2,28,NA,NA,NA
39,Elementary,Male,Black,No,0,7465,657,6808,NA,NA,NA
39,Elementary,Male,Black,No,1,1145,54,1091,NA,NA,NA
39,Elementary,Male,Black,Yes,0,3170,328,2842,NA,NA,NA
39,Elementary,Male,Black,Yes,1,150,11,139,NA,NA,NA
39,Elementary,Male,Hispanic,No,0,1235,128,1107,NA,NA,NA
39,Elementary,Male,Hispanic,No,1,390,45,345,NA,NA,NA
39,Elementary,Male,Hispanic,Yes,0,435,47,388,NA,NA,NA
39,Elementary,Male,Hispanic,Yes,1,174,21,153,NA,NA,NA
39,Elementary,Male,Other,No,0,1745,159,1586,NA,NA,NA
39,Elementary,Male,Other,No,1,1680,88,1592,NA,NA,NA
39,Elementary,Male,Other,Yes,0,627,49,578,NA,NA,NA
39,Elementary,Male,Other,Yes,1,105,7,98,NA,NA,NA
39,Elementary,Male,White,No,0,3414,320,3094,NA,NA,NA
39,Elementary,Male,White,No,1,517,57,460,NA,NA,NA
39,Elementary,Male,White,Yes,0,1990,152,1838,NA,NA,NA
39,Elementary,Male,White,Yes,1,50,10,40,NA,NA,NA
39,High,Female,Black,No,0,3788,313,3475,NA,NA,NA
39,High,Female,Black,No,1,605,34,571,NA,NA,NA
39,High,Female,Black,Yes,0,775,81,694,NA,NA,NA
39,High,Female,Black,Yes,1,67,3,64,NA,NA,NA
39,High,Female,Hispanic,No,0,617,50,567,NA,NA,NA
39,High,Female,Hispanic,No,1,365,59,306,NA,NA,NA
39,High,Female,Hispanic,Yes,0,95,8,87,NA,NA,NA
39,High,Female,Hispanic,Yes,1,95,8,87,NA,NA,NA
39,High,Female,Other,No,0,370,36,334,NA,NA,NA
39,High,Female,Other,No,1,915,47,868,NA,NA,NA
39,High,Female,Other,Yes,0,50,5,45,NA,NA,NA
39,High,Female,Other,Yes,1,20,6,14,NA,NA,NA
39,High,Female,White,No,0,1806,167,1639,NA,NA,NA
39,High,Female,White,No,1,200,4,196,NA,NA,NA
39,High,Female,White,Yes,0,480,67,413,NA,NA,NA
39,High,Male,Black,No,0,3075,223,2852,NA,NA,NA
39,High,Male,Black,No,1,630,34,596,NA,NA,NA
39,High,Male,Black,Yes,0,1288,141,1147,NA,NA,NA
39,High,Male,Black,Yes,1,60,3,57,NA,NA,NA
39,High,Male,Hispanic,No,0,405,56,349,NA,NA,NA
39,High,Male,Hispanic,No,1,405,56,349,NA,NA,NA
39,High,Male,Hispanic,Yes,0,110,9,101,NA,NA,NA
39,High,Male,Hispanic,Yes,1,165,31,134,NA,NA,NA
39,High,Male,Other,No,0,260,14,246,NA,NA,NA
39,High,Male,Other,No,1,935,59,876,NA,NA,NA
39,High,Male,Other,Yes,0,145,15,130,NA,NA,NA
39,High,Male,Other,Yes,1,35,1,34,NA,NA,NA
39,High,Male,White,No,0,1448,98,1350,NA,NA,NA
39,High,Male,White,No,1,260,20,240,NA,NA,NA
39,High,Male,White,Yes,0,550,67,483,NA,NA,NA
39,High,Male,White,Yes,1,5,2,3,NA,NA,NA
39,Middle,Female,Black,No,0,2533,35,2498,NA,NA,NA
39,Middle,Female,Black,No,1,403,4,399,NA,NA,NA
39,Middle,Female,Black,Yes,0,475,16,459,NA,NA,NA
39,Middle,Female,Black,Yes,1,40,3,37,NA,NA,NA
39,Middle,Female,Hispanic,No,0,398,18,380,NA,NA,NA
39,Middle,Female,Hispanic,No,1,245,7,238,NA,NA,NA
39,Middle,Female,Hispanic,Yes,0,50,1,49,NA,NA,NA
39,Middle,Female,Hispanic,Yes,1,45,1,44,NA,NA,NA
39,Middle,Female,Other,No,0,300,7,293,NA,NA,NA
39,Middle,Female,Other,No,1,520,10,510,NA,NA,NA
39,Middle,Female,Other,Yes,0,70,3,67,NA,NA,NA
39,Middle,Female,Other,Yes,1,10,2,8,NA,NA,NA
39,Middle,Female,White,No,0,1450,31,1419,NA,NA,NA
39,Middle,Female,White,No,1,158,4,154,NA,NA,NA
39,Middle,Female,White,Yes,0,280,15,265,NA,NA,NA
39,Middle,Female,White,Yes,1,5,0,5,NA,NA,NA
39,Middle,Male,Black,No,0,2229,45,2184,NA,NA,NA
39,Middle,Male,Black,No,1,368,1,367,NA,NA,NA
39,Middle,Male,Black,Yes,0,1120,28,1092,NA,NA,NA
39,Middle,Male,Black,Yes,1,70,1,69,NA,NA,NA
39,Middle,Male,Hispanic,No,0,329,10,319,NA,NA,NA
39,Middle,Male,Hispanic,No,1,210,10,200,NA,NA,NA
39,Middle,Male,Hispanic,Yes,0,180,4,176,NA,NA,NA
39,Middle,Male,Hispanic,Yes,1,60,4,56,NA,NA,NA
39,Middle,Male,Other,No,0,330,16,314,NA,NA,NA
39,Middle,Male,Other,No,1,585,6,579,NA,NA,NA
39,Middle,Male,Other,Yes,0,100,11,89,NA,NA,NA
39,Middle,Male,Other,Yes,1,55,0,55,NA,NA,NA
39,Middle,Male,White,No,0,1455,47,1408,NA,NA,NA
39,Middle,Male,White,No,1,183,8,175,NA,NA,NA
39,Middle,Male,White,Yes,0,607,31,576,NA,NA,NA
39,Middle,Male,White,Yes,1,15,0,15,NA,NA,NA
39,Other,Female,Black,No,0,2522,250,2272,NA,NA,NA
39,Other,Female,Black,No,1,175,5,170,NA,NA,NA
39,Other,Female,Black,Yes,0,325,54,271,NA,NA,NA
39,Other,Female,Black,Yes,1,15,2,13,NA,NA,NA
39,Other,Female,Hispanic,No,0,747,100,647,NA,NA,NA
39,Other,Female,Hispanic,No,1,925,117,808,NA,NA,NA
39,Other,Female,Hispanic,Yes,0,85,7,78,NA,NA,NA
39,Other,Female,Hispanic,Yes,1,225,27,198,NA,NA,NA
39,Other,Female,Other,No,0,320,35,285,NA,NA,NA
39,Other,Female,Other,No,1,265,12,253,NA,NA,NA
39,Other,Female,Other,Yes,0,40,3,37,NA,NA,NA
39,Other,Female,Other,Yes,1,10,0,10,NA,NA,NA
39,Other,Female,White,No,0,637,75,562,NA,NA,NA
39,Other,Female,White,No,1,60,2,58,NA,NA,NA
39,Other,Female,White,Yes,0,165,19,146,NA,NA,NA
39,Other,Female,White,Yes,1,10,2,8,NA,NA,NA
39,Other,Male,Black,No,0,2579,243,2336,NA,NA,NA
39,Other,Male,Black,No,1,160,11,149,NA,NA,NA
39,Other,Male,Black,Yes,0,925,126,799,NA,NA,NA
39,Other,Male,Black,Yes,1,30,9,21,NA,NA,NA
39,Other,Male,Hispanic,No,0,660,86,574,NA,NA,NA
39,Other,Male,Hispanic,No,1,970,131,839,NA,NA,NA
39,Other,Male,Hispanic,Yes,0,280,57,223,NA,NA,NA
39,Other,Male,Hispanic,Yes,1,565,80,485,NA,NA,NA
39,Other,Male,Other,No,0,260,27,233,NA,NA,NA
39,Other,Male,Other,No,1,260,19,241,NA,NA,NA
39,Other,Male,Other,Yes,0,140,37,103,NA,NA,NA
39,Other,Male,Other,Yes,1,5,2,3,NA,NA,NA
39,Other,Male,White,No,0,800,71,729,NA,NA,NA
39,Other,Male,White,No,1,40,7,33,NA,NA,NA
39,Other,Male,White,Yes,0,455,51,404,NA,NA,NA
39,Other,Male,White,Yes,1,20,5,15,NA,NA,NA
40,Elementary,Female,Black,No,0,8115,743,7372,NA,NA,NA
40,Elementary,Female,Black,No,1,1195,69,1126,NA,NA,NA
40,Elementary,Female,Black,Yes,0,1520,180,1340,NA,NA,NA
40,Elementary,Female,Black,Yes,1,50,4,46,NA,NA,NA
40,Elementary,Female,Hispanic,No,0,1285,129,1156,NA,NA,NA
40,Elementary,Female,Hispanic,No,1,355,39,316,NA,NA,NA
40,Elementary,Female,Hispanic,Yes,0,250,35,215,NA,NA,NA
40,Elementary,Female,Hispanic,Yes,1,140,15,125,NA,NA,NA
40,Elementary,Female,Other,No,0,1915,195,1720,NA,NA,NA
40,Elementary,Female,Other,No,1,1445,83,1362,NA,NA,NA
40,Elementary,Female,Other,Yes,0,305,30,275,NA,NA,NA
40,Elementary,Female,Other,Yes,1,45,3,42,NA,NA,NA
40,Elementary,Female,White,No,0,4045,318,3727,NA,NA,NA
40,Elementary,Female,White,No,1,470,47,423,NA,NA,NA
40,Elementary,Female,White,Yes,0,1095,99,996,NA,NA,NA
40,Elementary,Female,White,Yes,1,30,1,29,NA,NA,NA
40,Elementary,Male,Black,No,0,7465,719,6746,NA,NA,NA
40,Elementary,Male,Black,No,1,1140,59,1081,NA,NA,NA
40,Elementary,Male,Black,Yes,0,3170,371,2799,NA,NA,NA
40,Elementary,Male,Black,Yes,1,150,9,141,NA,NA,NA
40,Elementary,Male,Hispanic,No,0,1235,140,1095,NA,NA,NA
40,Elementary,Male,Hispanic,No,1,390,44,346,NA,NA,NA
40,Elementary,Male,Hispanic,Yes,0,435,44,391,NA,NA,NA
40,Elementary,Male,Hispanic,Yes,1,170,26,144,NA,NA,NA
40,Elementary,Male,Other,No,0,1745,155,1590,NA,NA,NA
40,Elementary,Male,Other,No,1,1680,81,1599,NA,NA,NA
40,Elementary,Male,Other,Yes,0,630,66,564,NA,NA,NA
40,Elementary,Male,Other,Yes,1,105,10,95,NA,NA,NA
40,Elementary,Male,White,No,0,3418,299,3119,NA,NA,NA
40,Elementary,Male,White,No,1,515,68,447,NA,NA,NA
40,Elementary,Male,White,Yes,0,1990,169,1821,NA,NA,NA
40,Elementary,Male,White,Yes,1,50,6,44,NA,NA,NA
40,High,Female,Black,No,0,2270,182,2088,NA,NA,NA
40,High,Female,Black,No,1,363,14,349,NA,NA,NA
40,High,Female,Black,Yes,0,465,39,426,NA,NA,NA
40,High,Female,Black,Yes,1,39,0,39,NA,NA,NA
40,High,Female,Hispanic,No,0,371,36,335,NA,NA,NA
40,High,Female,Hispanic,No,1,218,37,181,NA,NA,NA
40,High,Female,Hispanic,Yes,0,57,5,52,NA,NA,NA
40,High,Female,Hispanic,Yes,1,57,8,49,NA,NA,NA
40,High,Female,Other,No,0,222,24,198,NA,NA,NA
40,High,Female,Other,No,1,549,22,527,NA,NA,NA
40,High,Female,Other,Yes,0,30,3,27,NA,NA,NA
40,High,Female,Other,Yes,1,12,4,8,NA,NA,NA
40,High,Female,White,No,0,1083,91,992,NA,NA,NA
40,High,Female,White,No,1,120,4,116,NA,NA,NA
40,High,Female,White,Yes,0,288,36,252,NA,NA,NA
40,High,Male,Black,No,0,1841,128,1713,NA,NA,NA
40,High,Male,Black,No,1,373,16,357,NA,NA,NA
40,High,Male,Black,Yes,0,769,80,689,NA,NA,NA
40,High,Male,Black,Yes,1,36,4,32,NA,NA,NA
40,High,Male,Hispanic,No,0,243,33,210,NA,NA,NA
40,High,Male,Hispanic,No,1,240,28,212,NA,NA,NA
40,High,Male,Hispanic,Yes,0,66,8,58,NA,NA,NA
40,High,Male,Hispanic,Yes,1,99,12,87,NA,NA,NA
40,High,Male,Other,No,0,156,11,145,NA,NA,NA
40,High,Male,Other,No,1,561,34,527,NA,NA,NA
40,High,Male,Other,Yes,0,87,6,81,NA,NA,NA
40,High,Male,Other,Yes,1,21,1,20,NA,NA,NA
40,High,Male,White,No,0,868,56,812,NA,NA,NA
40,High,Male,White,No,1,156,14,142,NA,NA,NA
40,High,Male,White,Yes,0,330,34,296,NA,NA,NA
40,High,Male,White,Yes,1,3,0,3,NA,NA,NA
40,Middle,Female,Black,No,0,2530,49,2481,NA,NA,NA
40,Middle,Female,Black,No,1,409,6,403,NA,NA,NA
40,Middle,Female,Black,Yes,0,475,16,459,NA,NA,NA
40,Middle,Female,Black,Yes,1,40,0,40,NA,NA,NA
40,Middle,Female,Hispanic,No,0,400,21,379,NA,NA,NA
40,Middle,Female,Hispanic,No,1,245,5,240,NA,NA,NA
40,Middle,Female,Hispanic,Yes,0,50,3,47,NA,NA,NA
40,Middle,Female,Hispanic,Yes,1,45,2,43,NA,NA,NA
40,Middle,Female,Other,No,0,300,4,296,NA,NA,NA
40,Middle,Female,Other,No,1,522,10,512,NA,NA,NA
40,Middle,Female,Other,Yes,0,70,5,65,NA,NA,NA
40,Middle,Female,Other,Yes,1,10,0,10,NA,NA,NA
40,Middle,Female,White,No,0,1450,28,1422,NA,NA,NA
40,Middle,Female,White,No,1,160,5,155,NA,NA,NA
40,Middle,Female,White,Yes,0,280,8,272,NA,NA,NA
40,Middle,Female,White,Yes,1,5,0,5,NA,NA,NA
40,Middle,Male,Black,No,0,2229,60,2169,NA,NA,NA
40,Middle,Male,Black,No,1,370,3,367,NA,NA,NA
40,Middle,Male,Black,Yes,0,1120,30,1090,NA,NA,NA
40,Middle,Male,Black,Yes,1,70,3,67,NA,NA,NA
40,Middle,Male,Hispanic,No,0,330,10,320,NA,NA,NA
40,Middle,Male,Hispanic,No,1,210,5,205,NA,NA,NA
40,Middle,Male,Hispanic,Yes,0,180,6,174,NA,NA,NA
40,Middle,Male,Hispanic,Yes,1,60,4,56,NA,NA,NA
40,Middle,Male,Other,No,0,330,12,318,NA,NA,NA
40,Middle,Male,Other,No,1,585,1,584,NA,NA,NA
40,Middle,Male,Other,Yes,0,100,13,87,NA,NA,NA
40,Middle,Male,Other,Yes,1,55,1,54,NA,NA,NA
40,Middle,Male,White,No,0,1455,49,1406,NA,NA,NA
40,Middle,Male,White,No,1,185,5,180,NA,NA,NA
40,Middle,Male,White,Yes,0,610,33,577,NA,NA,NA
40,Middle,Male,White,Yes,1,15,0,15,NA,NA,NA
40,Other,Female,Black,No,0,2010,241,1769,NA,NA,NA
40,Other,Female,Black,No,1,155,10,145,NA,NA,NA
40,Other,Female,Black,Yes,0,249,42,207,NA,NA,NA
40,Other,Female,Black,Yes,1,15,2,13,NA,NA,NA
40,Other,Female,Hispanic,No,0,659,97,562,NA,NA,NA
40,Other,Female,Hispanic,No,1,863,137,726,NA,NA,NA
40,Other,Female,Hispanic,Yes,0,79,15,64,NA,NA,NA
40,Other,Female,Hispanic,Yes,1,217,34,183,NA,NA,NA
40,Other,Female,Other,No,0,294,37,257,NA,NA,NA
40,Other,Female,Other,No,1,215,11,204,NA,NA,NA
40,Other,Female,Other,Yes,0,34,3,31,NA,NA,NA
40,Other,Female,Other,Yes,1,6,0,6,NA,NA,NA
40,Other,Female,White,No,0,508,48,460,NA,NA,NA
40,Other,Female,White,No,1,48,2,46,NA,NA,NA
40,Other,Female,White,Yes,0,133,11,122,NA,NA,NA
40,Other,Female,White,Yes,1,10,3,7,NA,NA,NA
40,Other,Male,Black,No,0,2027,202,1825,NA,NA,NA
40,Other,Male,Black,No,1,136,24,112,NA,NA,NA
40,Other,Male,Black,Yes,0,795,142,653,NA,NA,NA
40,Other,Male,Black,Yes,1,28,10,18,NA,NA,NA
40,Other,Male,Hispanic,No,0,588,74,514,NA,NA,NA
40,Other,Male,Hispanic,No,1,883,147,736,NA,NA,NA
40,Other,Male,Hispanic,Yes,0,268,48,220,NA,NA,NA
40,Other,Male,Hispanic,Yes,1,537,93,444,NA,NA,NA
40,Other,Male,Other,No,0,224,35,189,NA,NA,NA
40,Other,Male,Other,No,1,216,12,204,NA,NA,NA
40,Other,Male,Other,Yes,0,131,27,104,NA,NA,NA
40,Other,Male,Other,Yes,1,5,3,2,NA,NA,NA
40,Other,Male,White,No,0,619,55,564,NA,NA,NA
40,Other,Male,White,No,1,30,8,22,NA,NA,NA
40,Other,Male,White,Yes,0,399,55,344,NA,NA,NA
40,Other,Male,White,Yes,1,18,3,15,NA,NA,NA
41,Elementary,Female,Black,No,0,8115,1059,7056,NA,NA,NA
41,Elementary,Female,Black,No,1,1195,95,1100,NA,NA,NA
41,Elementary,Female,Black,Yes,0,1517,225,1292,NA,NA,NA
41,Elementary,Female,Black,Yes,1,50,1,49,NA,NA,NA
41,Elementary,Female,Hispanic,No,0,1285,188,1097,NA,NA,NA
41,Elementary,Female,Hispanic,No,1,350,82,268,NA,NA,NA
41,Elementary,Female,Hispanic,Yes,0,250,41,209,NA,NA,NA
41,Elementary,Female,Hispanic,Yes,1,140,28,112,NA,NA,NA
41,Elementary,Female,Other,No,0,1915,235,1680,NA,NA,NA
41,Elementary,Female,Other,No,1,1445,81,1364,NA,NA,NA
41,Elementary,Female,Other,Yes,0,305,39,266,NA,NA,NA
41,Elementary,Female,Other,Yes,1,45,3,42,NA,NA,NA
41,Elementary,Female,White,No,0,4045,380,3665,NA,NA,NA
41,Elementary,Female,White,No,1,470,83,387,NA,NA,NA
41,Elementary,Female,White,Yes,0,1095,130,965,NA,NA,NA
41,Elementary,Female,White,Yes,1,30,3,27,NA,NA,NA
41,Elementary,Male,Black,No,0,7465,899,6566,NA,NA,NA
41,Elementary,Male,Black,No,1,1140,86,1054,NA,NA,NA
41,Elementary,Male,Black,Yes,0,3170,507,2663,NA,NA,NA
41,Elementary,Male,Black,Yes,1,150,11,139,NA,NA,NA
41,Elementary,Male,Hispanic,No,0,1235,215,1020,NA,NA,NA
41,Elementary,Male,Hispanic,No,1,388,88,300,NA,NA,NA
41,Elementary,Male,Hispanic,Yes,0,435,99,336,NA,NA,NA
41,Elementary,Male,Hispanic,Yes,1,170,49,121,NA,NA,NA
41,Elementary,Male,Other,No,0,1745,199,1546,NA,NA,NA
41,Elementary,Male,Other,No,1,1680,123,1557,NA,NA,NA
41,Elementary,Male,Other,Yes,0,630,74,556,NA,NA,NA
41,Elementary,Male,Other,Yes,1,105,15,90,NA,NA,NA
41,Elementary,Male,White,No,0,3420,371,3049,NA,NA,NA
41,Elementary,Male,White,No,1,515,131,384,NA,NA,NA
41,Elementary,Male,White,Yes,0,1990,243,1747,NA,NA,NA
41,Elementary,Male,White,Yes,1,50,8,42,NA,NA,NA
41,Middle,Female,Black,No,0,2527,26,2501,NA,NA,NA
41,Middle,Female,Black,No,1,410,4,406,NA,NA,NA
41,Middle,Female,Black,Yes,0,475,13,462,NA,NA,NA
41,Middle,Female,Black,Yes,1,40,1,39,NA,NA,NA
41,Middle,Female,Hispanic,No,0,400,14,386,NA,NA,NA
41,Middle,Female,Hispanic,No,1,244,7,237,NA,NA,NA
41,Middle,Female,Hispanic,Yes,0,50,3,47,NA,NA,NA
41,Middle,Female,Hispanic,Yes,1,45,0,45,NA,NA,NA
41,Middle,Female,Other,No,0,300,1,299,NA,NA,NA
41,Middle,Female,Other,No,1,525,7,518,NA,NA,NA
41,Middle,Female,Other,Yes,0,70,3,67,NA,NA,NA
41,Middle,Female,Other,Yes,1,10,1,9,NA,NA,NA
41,Middle,Female,White,No,0,1450,26,1424,NA,NA,NA
41,Middle,Female,White,No,1,160,3,157,NA,NA,NA
41,Middle,Female,White,Yes,0,280,2,278,NA,NA,NA
41,Middle,Female,White,Yes,1,5,0,5,NA,NA,NA
41,Middle,Male,Black,No,0,2233,45,2188,NA,NA,NA
41,Middle,Male,Black,No,1,370,4,366,NA,NA,NA
41,Middle,Male,Black,Yes,0,1120,31,1089,NA,NA,NA
41,Middle,Male,Black,Yes,1,70,0,70,NA,NA,NA
41,Middle,Male,Hispanic,No,0,330,6,324,NA,NA,NA
41,Middle,Male,Hispanic,No,1,210,4,206,NA,NA,NA
41,Middle,Male,Hispanic,Yes,0,180,7,173,NA,NA,NA
41,Middle,Male,Hispanic,Yes,1,60,2,58,NA,NA,NA
41,Middle,Male,Other,No,0,328,9,319,NA,NA,NA
41,Middle,Male,Other,No,1,585,7,578,NA,NA,NA
41,Middle,Male,Other,Yes,0,100,10,90,NA,NA,NA
41,Middle,Male,Other,Yes,1,55,1,54,NA,NA,NA
41,Middle,Male,White,No,0,1455,37,1418,NA,NA,NA
41,Middle,Male,White,No,1,185,11,174,NA,NA,NA
41,Middle,Male,White,Yes,0,610,20,590,NA,NA,NA
41,Middle,Male,White,Yes,1,15,0,15,NA,NA,NA
41,Other,Female,Black,No,0,1242,174,1068,NA,NA,NA
41,Other,Female,Black,No,1,125,10,115,NA,NA,NA
41,Other,Female,Black,Yes,0,135,29,106,NA,NA,NA
41,Other,Female,Black,Yes,1,15,3,12,NA,NA,NA
41,Other,Female,Hispanic,No,0,525,107,418,NA,NA,NA
41,Other,Female,Hispanic,No,1,770,205,565,NA,NA,NA
41,Other,Female,Hispanic,Yes,0,70,14,56,NA,NA,NA
41,Other,Female,Hispanic,Yes,1,205,49,156,NA,NA,NA
41,Other,Female,Other,No,0,255,39,216,NA,NA,NA
41,Other,Female,Other,No,1,140,14,126,NA,NA,NA
41,Other,Female,Other,Yes,0,25,5,20,NA,NA,NA
41,Other,Female,White,No,0,315,30,285,NA,NA,NA
41,Other,Female,White,No,1,30,7,23,NA,NA,NA
41,Other,Female,White,Yes,0,85,11,74,NA,NA,NA
41,Other,Female,White,Yes,1,10,4,6,NA,NA,NA
41,Other,Male,Black,No,0,1215,204,1011,NA,NA,NA
41,Other,Male,Black,No,1,100,20,80,NA,NA,NA
41,Other,Male,Black,Yes,0,605,160,445,NA,NA,NA
41,Other,Male,Black,Yes,1,25,8,17,NA,NA,NA
41,Other,Male,Hispanic,No,0,480,93,387,NA,NA,NA
41,Other,Male,Hispanic,No,1,757,195,562,NA,NA,NA
41,Other,Male,Hispanic,Yes,0,250,70,180,NA,NA,NA
41,Other,Male,Hispanic,Yes,1,495,132,363,NA,NA,NA
41,Other,Male,Other,No,0,170,31,139,NA,NA,NA
41,Other,Male,Other,No,1,150,15,135,NA,NA,NA
41,Other,Male,Other,Yes,0,120,33,87,NA,NA,NA
41,Other,Male,Other,Yes,1,5,3,2,NA,NA,NA
41,Other,Male,White,No,0,355,45,310,NA,NA,NA
41,Other,Male,White,No,1,15,14,1,NA,NA,NA
41,Other,Male,White,Yes,0,315,38,277,NA,NA,NA
41,Other,Male,White,Yes,1,15,5,10,NA,NA,NA
42,Elementary,Female,Black,No,0,1623,451,1172,NA,NA,NA
42,Elementary,Female,Black,No,1,239,31,208,NA,NA,NA
42,Elementary,Female,Black,Yes,0,303,84,219,NA,NA,NA
42,Elementary,Female,Black,Yes,1,10,2,8,NA,NA,NA
42,Elementary,Female,Hispanic,No,0,257,71,186,NA,NA,NA
42,Elementary,Female,Hispanic,No,1,70,32,38,NA,NA,NA
42,Elementary,Female,Hispanic,Yes,0,50,17,33,NA,NA,NA
42,Elementary,Female,Hispanic,Yes,1,28,13,15,NA,NA,NA
42,Elementary,Female,Other,No,0,383,93,290,NA,NA,NA
42,Elementary,Female,Other,No,1,289,22,267,NA,NA,NA
42,Elementary,Female,Other,Yes,0,61,16,45,NA,NA,NA
42,Elementary,Female,Other,Yes,1,9,3,6,NA,NA,NA
42,Elementary,Female,White,No,0,809,145,664,NA,NA,NA
42,Elementary,Female,White,No,1,94,31,63,NA,NA,NA
42,Elementary,Female,White,Yes,0,219,54,165,NA,NA,NA
42,Elementary,Female,White,Yes,1,6,1,5,NA,NA,NA
42,Elementary,Male,Black,No,0,1493,404,1089,NA,NA,NA
42,Elementary,Male,Black,No,1,228,29,199,NA,NA,NA
42,Elementary,Male,Black,Yes,0,634,205,429,NA,NA,NA
42,Elementary,Male,Black,Yes,1,30,4,26,NA,NA,NA
42,Elementary,Male,Hispanic,No,0,247,92,155,NA,NA,NA
42,Elementary,Male,Hispanic,No,1,77,26,51,NA,NA,NA
42,Elementary,Male,Hispanic,Yes,0,87,32,55,NA,NA,NA
42,Elementary,Male,Hispanic,Yes,1,34,15,19,NA,NA,NA
42,Elementary,Male,Other,No,0,349,84,265,NA,NA,NA
42,Elementary,Male,Other,No,1,336,47,289,NA,NA,NA
42,Elementary,Male,Other,Yes,0,126,40,86,NA,NA,NA
42,Elementary,Male,Other,Yes,1,21,3,18,NA,NA,NA
42,Elementary,Male,White,No,0,684,134,550,NA,NA,NA
42,Elementary,Male,White,No,1,103,37,66,NA,NA,NA
42,Elementary,Male,White,Yes,0,398,91,307,NA,NA,NA
42,Elementary,Male,White,Yes,1,10,3,7,NA,NA,NA
42,Middle,Female,Black,No,0,505,15,490,NA,NA,NA
42,Middle,Female,Black,No,1,82,3,79,NA,NA,NA
42,Middle,Female,Black,Yes,0,95,11,84,NA,NA,NA
42,Middle,Female,Black,Yes,1,8,1,7,NA,NA,NA
42,Middle,Female,Hispanic,No,0,80,5,75,NA,NA,NA
42,Middle,Female,Hispanic,No,1,48,2,46,NA,NA,NA
42,Middle,Female,Hispanic,Yes,0,9,0,9,NA,NA,NA
42,Middle,Female,Hispanic,Yes,1,9,1,8,NA,NA,NA
42,Middle,Female,Other,No,0,60,3,57,NA,NA,NA
42,Middle,Female,Other,No,1,105,10,95,NA,NA,NA
42,Middle,Female,Other,Yes,0,14,1,13,NA,NA,NA
42,Middle,Female,Other,Yes,1,2,1,1,NA,NA,NA
42,Middle,Female,White,No,0,290,12,278,NA,NA,NA
42,Middle,Female,White,No,1,32,2,30,NA,NA,NA
42,Middle,Female,White,Yes,0,56,4,52,NA,NA,NA
42,Middle,Female,White,Yes,1,1,0,1,NA,NA,NA
42,Middle,Male,Black,No,0,446,15,431,NA,NA,NA
42,Middle,Male,Black,No,1,74,1,73,NA,NA,NA
42,Middle,Male,Black,Yes,0,224,11,213,NA,NA,NA
42,Middle,Male,Black,Yes,1,14,0,14,NA,NA,NA
42,Middle,Male,Hispanic,No,0,66,4,62,NA,NA,NA
42,Middle,Male,Hispanic,No,1,42,1,41,NA,NA,NA
42,Middle,Male,Hispanic,Yes,0,36,4,32,NA,NA,NA
42,Middle,Male,Hispanic,Yes,1,12,1,11,NA,NA,NA
42,Middle,Male,Other,No,0,65,4,61,NA,NA,NA
42,Middle,Male,Other,No,1,117,7,110,NA,NA,NA
42,Middle,Male,Other,Yes,0,20,0,20,NA,NA,NA
42,Middle,Male,Other,Yes,1,11,0,11,NA,NA,NA
42,Middle,Male,White,No,0,291,26,265,NA,NA,NA
42,Middle,Male,White,No,1,37,2,35,NA,NA,NA
42,Middle,Male,White,Yes,0,122,5,117,NA,NA,NA
42,Middle,Male,White,Yes,1,3,0,3,NA,NA,NA
42,Other,Female,Black,No,0,249,62,187,NA,NA,NA
42,Other,Female,Black,No,1,25,4,21,NA,NA,NA
42,Other,Female,Black,Yes,0,27,7,20,NA,NA,NA
42,Other,Female,Black,Yes,1,3,2,1,NA,NA,NA
42,Other,Female,Hispanic,No,0,105,35,70,NA,NA,NA
42,Other,Female,Hispanic,No,1,154,68,86,NA,NA,NA
42,Other,Female,Hispanic,Yes,0,14,5,9,NA,NA,NA
42,Other,Female,Hispanic,Yes,1,41,18,23,NA,NA,NA
42,Other,Female,Other,No,0,51,11,40,NA,NA,NA
42,Other,Female,Other,No,1,28,7,21,NA,NA,NA
42,Other,Female,Other,Yes,0,5,1,4,NA,NA,NA
42,Other,Female,White,No,0,63,11,52,NA,NA,NA
42,Other,Female,White,No,1,6,2,4,NA,NA,NA
42,Other,Female,White,Yes,0,17,2,15,NA,NA,NA
42,Other,Female,White,Yes,1,2,1,1,NA,NA,NA
42,Other,Male,Black,No,0,243,58,185,NA,NA,NA
42,Other,Male,Black,No,1,20,4,16,NA,NA,NA
42,Other,Male,Black,Yes,0,121,24,97,NA,NA,NA
42,Other,Male,Black,Yes,1,5,3,2,NA,NA,NA
42,Other,Male,Hispanic,No,0,96,40,56,NA,NA,NA
42,Other,Male,Hispanic,No,1,151,68,83,NA,NA,NA
42,Other,Male,Hispanic,Yes,0,50,17,33,NA,NA,NA
42,Other,Male,Hispanic,Yes,1,99,45,54,NA,NA,NA
42,Other,Male,Other,No,0,34,7,27,NA,NA,NA
42,Other,Male,Other,No,1,30,8,22,NA,NA,NA
42,Other,Male,Other,Yes,0,24,4,20,NA,NA,NA
42,Other,Male,Other,Yes,1,1,0,1,NA,NA,NA
42,Other,Male,White,No,0,71,10,61,NA,NA,NA
42,Other,Male,White,No,1,3,3,0,NA,NA,NA
42,Other,Male,White,Yes,0,63,7,56,NA,NA,NA
42,Other,Male,White,Yes,1,3,1,2,NA,NA,NA
